TUs	TU_Genes	Gene_Names
ppA	ppa	ppa
pykA	pykA	pykA
cirA	cirA	cirA
ygiV	ygiV	ygiV
stpA	stpA	stpA
yghA	yghA	yghA
mqsRA	mqsA // mqsR	mqsA // mqsR
mngAB	mngB // mngA	mngB // mngA
nadAp // pnuC // nadA	pnuC // nadA	pnuC // nadA
yciZT	yciZ // yciT	yciZ // yciT
yebO	yebO	yebO
mpl	mpl	mpl
yghS // yghR	yghS // yghR	yghS // yghR
focA-pflB	pflB // focA	pflB // focA
holD-rimI-yjjG	yjjG // rimI // holD	yjjG // rimI // holD
yrbN-deaD	deaD // yrbN	deaD // yrbN
opgB	opgB	opgB
tsaE-amiB-mutL-miaA-hfq-hflXKC	hflC // hflK // hflX // hfq // miaA // mutL // amiB // tsaE	hflC // hflK // hflX // hfq // miaA // mutL // amiB // tsaE
rpoE-rseABC	rseD // rseC // rseB // rseA // rpoE	rseD // rseC // rseB // rseA // rpoE
pcnB-folK	folK // pcnB	folK // pcnB
chiP-ybfN	chiQ // chiP	chiQ // chiP
yeaO	yeaO	yeaO
rplT-pheM	pheM // rplT	pheM // rplT
sfsA-dksA	dksA // sfsA	dksA // sfsA
argO	argO	argO
topAI // yjhQ	topAI // yjhQ	topAI // yjhQ
gadW	gadW	gadW
yibN-grxC-secB-gpsA	grxC // yibN // gpsA // secB	grxC // yibN // gpsA // secB
scpA-argK-scpBC	scpC // scpB // argK // scpA	scpC // scpB // argK // scpA
tatE	tatE	tatE
ynjD // ynjC // ynjB // ynjA // ydjZ // ydjY // ydjX	ynjD // ynjC // ynjB // ynjA // ydjZ // ydjY // ydjX	ynjD // ynjC // ynjB // ynjA // ydjZ // ydjY // ydjX
insH-5	insH5	insH5
rpmBG	rpmG // rpmB	rpmG // rpmB
ygfK-ssnA	ssnA // ygfK	ssnA // ygfK
intB	intB	intB
pstSCA	pstA // pstC // pstS	pstA // pstC // pstS
lapAB	lapB // lapA	lapB // lapA
ybdF	ybdF	ybdF
ydiL	ydiL	ydiL
nhoA	nhoA	nhoA
potFGHI	potF // potG // potH // potI	potF // potG // potH // potI
ygeI	ygeI	ygeI
cysQ	cysQ	cysQ
groL	groL	groL
feaR	feaR	feaR
sfmF // sfmH	sfmF // sfmH	sfmF // sfmH
ydjM	ydjM	ydjM
anmK	anmK	anmK
ggt	ggt	ggt
rppH-ptsP	rppH // ptsP	rppH // ptsP
nfrBA	nfrA // nfrB	nfrA // nfrB
ecnB // ecnA	ecnB // ecnA	ecnB // ecnA
rpoS	rpoS	rpoS
ycjY-ymjDC-mpaA	mpaA // ymjC // ymjD // ycjY	mpaA // ymjC // ymjD // ycjY
dnaX	dnaX	dnaX
pheP	pheP	pheP
clcB	clcB	clcB
cspH	cspH	cspH
ygcR // ygcQ	ygcR // ygcQ	ygcR // ygcQ
hyaABCDEF	hyaA // hyaB // hyaC // hyaD // hyaE // hyaF	hyaA // hyaB // hyaC // hyaD // hyaE // hyaF
yjcO	yjcO	yjcO
clsA-yciU	yciU // clsA	yciU // clsA
yeaGH	yeaH // yeaG	yeaH // yeaG
fumAC	fumC // fumA	fumC // fumA
fadM	fadM	fadM
dhaKLM	dhaM // dhaL // dhaK	dhaM // dhaL // dhaK
essQ // ydfR // rrrQ // rzpQ	essQ // ydfR // rrrQ // rzpQ	essQ // ydfR // rrrQ // rzpQ
abgR	abgR	abgR
ygaY	ygaY	ygaY
flgAMN	flgN // flgM // flgA	flgN // flgM // flgA
yjbE	yjbE	yjbE
pfkA	pfkA	pfkA
ecpBCDE	ecpE // ecpD // ecpC // ecpB	ecpE // ecpD // ecpC // ecpB
leuO	leuO	leuO
iprA	iprA	iprA
borD	borD	borD
sad	sad	sad
yfiK	eamB	eamB
yfjQ // yfjP	yfjQ // yfjP	yfjQ // yfjP
dadAX	dadA // dadX	dadA // dadX
yiiX	yiiX	yiiX
rpmH-rnpA	rnpA // rpmH	rnpA // rpmH
osmF-yehYXW	yehW // yehX // yehY // osmF	yehW // yehX // yehY // osmF
csrA	csrA	csrA
yahH	yahH	yahH
evgAS	evgS // evgA	evgS // evgA
yddW	yddW	yddW
yejK	yejK	yejK
rluD // pgeF	rluD // pgeF	rluD // pgeF
arsRBC	arsR // arsB // arsC	arsR // arsB // arsC
yihR	yihR	yihR
degP	degP	degP
ykfGH-yafW-ykfI	ykfI // yafW // ykfH // ykfG	ykfI // yafW // ykfH // ykfG
yqjA-mzrA	mzrA // yqjA	mzrA // yqjA
ykgJ	ykgJ	ykgJ
prpR	prpR	prpR
mnaT // ydcZ	mnaT // ydcZ	mnaT // ydcZ
ydiP	ydiP	ydiP
trmJ	trmJ	trmJ
sdaA	sdaA	sdaA
bioP	bioP	bioP
mazEFG	mazG // mazF // mazE	mazG // mazF // mazE
tcyJ	tcyJ	tcyJ
ydeI	ydeI	ydeI
perR	perR	perR
rpoBC	rpoC // rpoB	rpoC // rpoB
hokB	hokB	hokB
ycjG	ycjG	ycjG
aegA	aegA	aegA
rbsDACBKR	rbsR // rbsD // rbsA // rbsC // rbsB // rbsK	rbsR // rbsD // rbsA // rbsC // rbsB // rbsK
yieP // hsrA	yieP // hsrA	yieP // hsrA
dadAX	dadX // dadA	dadX // dadA
yggDC	yggC // fumE	yggC // fumE
pal // cpoB // tolB	pal // cpoB // tolB	pal // cpoB // tolB
C0067	C0067	C0067
cstA	cstA	cstA
uspF	uspF	uspF
matP	matP	matP
ucpA	ucpA	ucpA
marRAB	marR // marA // marB	marR // marA // marB
yidE	yidE	yidE
ybgA-phr	phr // ybgA	phr // ybgA
ybeD-lipB	lipB // ybeD	lipB // ybeD
rapA-rluA	rluA // rapA	rluA // rapA
map // glnD // dapD	map // glnD // dapD	map // glnD // dapD
glnHPQ	glnQ // glnP // glnH	glnQ // glnP // glnH
abgA // abgB // abgT // ogt	abgA // abgB // abgT // ogt	abgA // abgB // abgT // ogt
yqjI	nfeR	nfeR
ypdJ	ypdJ	ypdJ
ihfA	ihfA	ihfA
yicC	yicC	yicC
ychQA-kdsA	kdsA // ychA // ychQ	kdsA // ychA // ychQ
ftsK	ftsK	ftsK
tufA	tufA	tufA
coaE // zapD // yacG	coaE // zapD // yacG	coaE // zapD // yacG
agaR	agaR	agaR
ycjD	ycjD	ycjD
ynjF	ynjF	ynjF
folX-yfcH	yfcH // folX	yfcH // folX
ndh	ndh	ndh
yiaW // yiaV	yiaW // yiaV	yiaW // yiaV
fimAICDFGH	fimD // fimH // fimG // fimF // fimC // fimI // fimA	fimD // fimH // fimG // fimF // fimC // fimI // fimA
eno	eno	eno
fhuF	fhuF	fhuF
insL1	insL1	insL1
sbcB	sbcB	sbcB
purU	purU	purU
yjiC	yjiC	yjiC
rbn	rbn	rbn
pck	pck	pck
yhjE	yhjE	yhjE
sdhCDAB-sucABCD-sdhX	sdhX // sdhC // sdhD // sdhA // sdhB // sucA // sucB // sucC // sucD	sdhX // sdhC // sdhD // sdhA // sdhB // sucA // sucB // sucC // sucD
dgt	dgt	dgt
bacA	bacA	bacA
dnaN-recF	recF // dnaN	recF // dnaN
aspC	aspC	aspC
yiiU	zapB	zapB
rplY terminator // rplVp // rplY	rplY	rplY
tdcABCDEFG	tdcG // tdcF // tdcE // tdcD // tdcC // tdcB // tdcA	tdcG // tdcF // tdcE // tdcD // tdcC // tdcB // tdcA
yrhC	yrhC	yrhC
serW	serW	serW
trpt	trpT	trpT
cydAB	cydB // cydA	cydB // cydA
ptsG	ptsG	ptsG
folA	folA	folA
ymfK	ymfK	ymfK
wecH	wecH	wecH
folE-yeiB	folE // yeiB	folE // yeiB
carAB	carA // carB	carA // carB
yhgF	yhgF	yhgF
lysT-valT-lysW	lysT // valT // lysW	lysT // valT // lysW
ydhM	nemR	nemR
metJ	metJ	metJ
ygbA	ygbA	ygbA
serC	serC	serC
murJ	murJ	murJ
yhaJ	yhaJ	yhaJ
yehK	yehK	yehK
fabA	fabA	fabA
bfd // bfr	bfd // bfr	bfd // bfr
ompC	ompC	ompC
sraB	sraB	sraB
treR	treR	treR
malQ	malQ	malQ
mutY-yggX-mltC	mltC // yggX // mutY	mltC // yggX // mutY
efeB // efeO	efeB // efeO	efeB // efeO
ybaK	ybaK	ybaK
trhP	trhP	trhP
araE	araE	araE
yhcB	yhcB	yhcB
emrRAB	mprA // emrA // emrB	mprA // emrA // emrB
glf-rfc	wbbH // glf	wbbH // glf
psiE	psiE	psiE
infA	infA	infA
pdxA-rsmA	rsmA // pdxA	rsmA // pdxA
mgsA	mgsA	mgsA
yadD	rpnC	rpnC
dacD terminator // dacD	dacD	dacD
pyrC	pyrC	pyrC
nlpI	nlpI	nlpI
rpoS	rpoS	rpoS
rhaM	rhaM	rhaM
ychF	ychF	ychF
uxaCA	uxaA // uxaC	uxaA // uxaC
pflA	pflA	pflA
ybaP	ybaP	ybaP
yodB	yodB	yodB
narGHJI	narG // narH // narJ // narI	narG // narH // narJ // narI
yqjG	yqjG	yqjG
icd	icd	icd
rne	rne	rne
aer	aer	aer
gadE	gadF // gadE	gadF // gadE
deoR	deoR	deoR
rluF	rluF	rluF
dcyD-tcyLN	dcyD // tcyL // tcyN	dcyD // tcyL // tcyN
glnLG	glnG // glnL	glnG // glnL
ygiF // glnE	ygiF // glnE	ygiF // glnE
ibpAB	ibpB // ibpA	ibpB // ibpA
yciY	yciY	yciY
rnlB	rnlB	rnlB
nfsB	nfsB	nfsB
cecR-ybhGFSR	cecR // ybhG // ybhF // ybhS // ybhR	cecR // ybhG // ybhF // ybhS // ybhR
pepN	pepN	pepN
yebF	yebF	yebF
aroP	aroP	aroP
parC	parC	parC
otsA	otsA	otsA
cyaY	cyaY	cyaY
flhDC	flhC // flhD	flhC // flhD
seqA-pgm	pgm // seqA	pgm // seqA
argA	argA	argA
mntP	mntP	mntP
sohB	sohB	sohB
pppA	pppA	pppA
xylFGHR	xylF // xylG // xylH // xylR	xylF // xylG // xylH // xylR
uhpABC	uhpC // uhpB // uhpA	uhpC // uhpB // uhpA
ydeA	ydeA	ydeA
exuT	exuT	exuT
sdiA	sdiA	sdiA
gapC_1C_2	gapC	gapC
ybeX // lnt	ybeX // lnt	ybeX // lnt
dgcJ	dgcJ	dgcJ
ligB	ligB	ligB
selAB	selB // selA	selB // selA
ssrS-ygfA	fau // ssrS	fau // ssrS
yjhIHG	yjhI // yjhH // yjhG	yjhI // yjhH // yjhG
murQP	murP // murQ	murP // murQ
ariR	ariR	ariR
queE	queE	queE
dpiBA	dpiA // dpiB	dpiA // dpiB
tcyP	tcyP	tcyP
insH-1	insH1	insH1
rplM-rpsI	rpsI // rplM	rpsI // rplM
yqeB	yqeB	yqeB
pepA	pepA	pepA
ssrS-ygfA	fau // ssrS	fau // ssrS
serC	serC	serC
tfaD	tfaD	tfaD
acrR	acrR	acrR
ydiJ // menI // ydiH	ydiJ // menI // ydiH	ydiJ // menI // ydiH
nudE	nudE	nudE
phoPQ	phoQ // phoP	phoQ // phoP
ygeF	ygeF	ygeF
cycA	cycA	cycA
alr	alr	alr
nanCMS	nanS // nanM // nanC	nanS // nanM // nanC
folD-ybcJ	folD // ybcJ	folD // ybcJ
nudB-yebC-ruvC	ruvC // yebC // nudB	ruvC // yebC // nudB
cnu	cnu	cnu
feaB	feaB	feaB
mltA	mltA	mltA
mreBCD	mreD // mreC // mreB	mreD // mreC // mreB
yjeI	yjeI	yjeI
yfgM	yfgM	yfgM
ilvL	ilvL	ilvL
priC // ybaM	priC // ybaM	priC // ybaM
ytfK	ytfK	ytfK
ynfA	ynfA	ynfA
chaA	chaA	chaA
cas3	cas3	cas3
hisLGDCBHAFI	hisL // hisG // hisD // hisC // hisB // hisH // hisA // hisF // hisI	hisL // hisG // hisD // hisC // hisB // hisH // hisA // hisF // hisI
yjcE	yjcE	yjcE
cdd	cdd	cdd
tyrS-pdxY	pdxY // tyrS	pdxY // tyrS
ibaG-murA	murA // ibaG	murA // ibaG
yajG	yajG	yajG
mdtABCD-baeSR	baeR // baeS // mdtD // mdtC // mdtB // mdtA	baeR // baeS // mdtD // mdtC // mdtB // mdtA
ydfO // ynfO	ydfO // ynfO	ydfO // ynfO
ttdR	ttdR	ttdR
yqaE	yqaE	yqaE
fdoGHI-fdhE	fdhE // fdoI // fdoH // fdoG	fdhE // fdoI // fdoH // fdoG
arpA	arpA	arpA
zraSR	zraR // zraS	zraR // zraS
uppS-cdsA	cdsA // uppS	cdsA // uppS
metH	metH	metH
ykiB	ykiB	ykiB
frc	frc	frc
yneE	yneE	yneE
yfiC	yfiC	yfiC
yfjJ	yfjJ	yfjJ
cobUST	cobT // cobS // cobU	cobT // cobS // cobU
yiiQ	yiiQ	yiiQ
xylAB	xylB // xylA	xylB // xylA
glnW-metU-glnVX	glnX // glnV // metU // glnW	glnX // glnV // metU // glnW
ppk-ppx	ppx // ppk	ppx // ppk
yahB	yahB	yahB
bglX	bglX	bglX
yddM	yddM	yddM
yegI	yegI	yegI
pssA	pssA	pssA
yjeFE-amiB-mutL-miaA-hfq-hflXKC	tsaE // nnr // amiB // mutL // miaA // hfq // hflX // hflK // hflC	tsaE // nnr // amiB // mutL // miaA // hfq // hflX // hflK // hflC
ompL	ompL	ompL
hlyE	hlyE	hlyE
nuoMN	nuoN // nuoM	nuoN // nuoM
hemA-prfA-prmC	prmC // prfA // hemA	prmC // prfA // hemA
intF	intF	intF
istR-1	istR	istR
patD	patD	patD
ydgC	ydgC	ydgC
ryfA	ryfA	ryfA
trpR	trpR	trpR
recQ	recQ	recQ
cfa	cfa	cfa
argQ	argQ	argQ
gadC terminator // gadC	gadC	gadC
cspG	cspG	cspG
ydcF	ydcF	ydcF
ychN	ychN	ychN
maeB	maeB	maeB
prs	prs	prs
mioC	mioC	mioC
fabDG-acpP	acpP // fabG // fabD	acpP // fabG // fabD
clpPX	clpX // clpP	clpX // clpP
gloB	gloB	gloB
sdhDAB	sdhB // sdhA // sdhD	sdhB // sdhA // sdhD
tfaR // stfR // lomR_2	tfaR // stfR	tfaR // stfR
ycaK	ycaK	ycaK
ligA-ypeB	ligA // ypeB	ligA // ypeB
malI	malI	malI
yidH // yidG // yidF	yidH // yidG // yidF	yidH // yidG // yidF
cydAB	cydB // cydA	cydB // cydA
glnS	glnS	glnS
acs-yjcHG	actP // yjcH // acs	actP // yjcH // acs
dgt	dgt	dgt
deoBD	deoD // deoB	deoD // deoB
insH4	insH4	insH4
yqgD	yqgD	yqgD
yfdO // yfdN // yfdM // yfdL // yfdK	yfdO // yfdN // yfdM // yfdL // yfdK	yfdO // yfdN // yfdM // yfdL // yfdK
gcvA	gcvA	gcvA
yibD	waaH	waaH
trpCBA	trpA // trpB // trpC	trpA // trpB // trpC
mraW-ftsLI-murEF-mraY-murD-ftsW-murGC-ddlB-ftsQAZ-lpxC	lpxC // ftsZ // ftsA // ftsQ // ddlB // murC // murG // ftsW // murD // mraY // murF // murE // ftsI // ftsL // rsmH	lpxC // ftsZ // ftsA // ftsQ // ddlB // murC // murG // ftsW // murD // mraY // murF // murE // ftsI // ftsL // rsmH
ssrS	ssrS	ssrS
cra	cra	cra
ssb	ssb	ssb
lapAB	lapB // lapA	lapB // lapA
yncE	yncE	yncE
yfcE	yfcE	yfcE
proP	proP	proP
yiaB	yiaB	yiaB
ompR-envZ	envZ // ompR	envZ // ompR
fliLMNOPQR	fliR // fliQ // fliP // fliO // fliN // fliM // fliL	fliR // fliQ // fliP // fliO // fliN // fliM // fliL
ddpXABCDF	ddpF // ddpD // ddpC // ddpB // ddpA // ddpX	ddpF // ddpD // ddpC // ddpB // ddpA // ddpX
mog	mog	mog
ppc	ppc	ppc
dauA	dauA	dauA
yjgZ	yjgZ	yjgZ
pmrD	pmrD	pmrD
aldB	aldB	aldB
yhjA	ccp	ccp
leuQPV	leuV // leuP // leuQ	leuV // leuP // leuQ
mreB	mreB	mreB
ybaB-recR	recR // ybaB	recR // ybaB
rrsD-ileU-alaU-rrlD-rrfD-thrV-rrfF	rrfF // thrV // rrfD // rrlD // alaU // ileU // rrsD	rrfF // thrV // rrfD // rrlD // alaU // ileU // rrsD
dapD	dapD	dapD
pdeG	pdeG	pdeG
yifE	maoP	maoP
bcr	bcr	bcr
glgCAP	glgP // glgA // glgC	glgP // glgA // glgC
acpT	acpT	acpT
glyVXY	glyV // glyX // glyY	glyV // glyX // glyY
ybiB	ybiB	ybiB
chiA	chiA	chiA
aqpZ	aqpZ	aqpZ
yraP	yraP	yraP
ymfE // ymfD	ymfE // ymfD	ymfE // ymfD
yhiN	yhiN	yhiN
yohJK	yohK // yohJ	yohK // yohJ
gltA	gltA	gltA
yrfG-hslR	hslR // yrfG	hslR // yrfG
aspV	aspV	aspV
yfgA	rodZ	rodZ
narU	narU	narU
ftnB	ftnB	ftnB
glnA	glnA	glnA
yceB terminator // yceB	yceB	yceB
ybiP	opgE	opgE
metG	metG	metG
glnB	glnB	glnB
arfA	arfA	arfA
glnB	glnB	glnB
C0299	C0299	C0299
mgtA	mgtL // mgtA	mgtL // mgtA
fliE	fliE	fliE
mutY-yggX-mltC-nupG	nupG // mltC // yggX // mutY	nupG // mltC // yggX // mutY
yccE	yccE	yccE
ybaZ	atl	atl
sibA	sibA	sibA
alkB	alkB	alkB
yhcG	yhcG	yhcG
corA	corA	corA
ftsB	ftsB	ftsB
osmY	osmY	osmY
bamB-der	der // bamB	der // bamB
rsmA-apaGH	apaH // apaG // rsmA	apaH // apaG // rsmA
rmf	rmf	rmf
mlaA	mlaA	mlaA
yeeX	yeeX	yeeX
purL	purL	purL
ubiV // ubiU	ubiV // ubiU	ubiV // ubiU
rpoD	rpoD	rpoD
alsK	alsK	alsK
osmC	osmC	osmC
plsX-fabHDG	fabG // fabD // fabH // plsX	fabG // fabD // fabH // plsX
serS	serS	serS
ryjA	ryjA	ryjA
hprR // hprS	hprR // hprS	hprR // hprS
metA	metA	metA
ygjV	ygjV	ygjV
clpB	clpB	clpB
asnC-mioC-mnmG	mnmG // mioC // asnC	mnmG // mioC // asnC
tsr	tsr	tsr
csrC	csrC	csrC
dgcI // pdeI	dgcI // pdeI	dgcI // pdeI
nsrR-rnr-rlmB-yjfI	yjfI // rlmB // rnr // nsrR	yjfI // rlmB // rnr // nsrR
yecA	yecA	yecA
galETKM	galM // galK // galT // galE	galM // galK // galT // galE
yqiK // yqiJ	yqiK // yqiJ	yqiK // yqiJ
yadV-htrE	htrE // yadV	htrE // yadV
yncL	yncL	yncL
ykfBF-yafX-ykfGH-yafW-ykfI	ykfI // yafW // ykfH // ykfG // yafX // ykfF // ykfB	ykfI // yafW // ykfH // ykfG // yafX // ykfF // ykfB
dcuB-fumB	fumB // dcuB	fumB // dcuB
ybhL	ybhL	ybhL
panD	panD	panD
exoX // yobB	exoX // yobB	exoX // yobB
aroG	aroG	aroG
ygiQ	ygiQ	ygiQ
osmB	osmB	osmB
slt	slt	slt
glrK	glrK	glrK
rplL	rplL	rplL
lysY // valZ	lysY // valZ	lysY // valZ
pdeD	pdeD	pdeD
lpxL	lpxL	lpxL
yqgA	yqgA	yqgA
yoaB	yoaB	yoaB
allR	allR	allR
hemW // rdgB // yggU // yggT // yggS	hemW // rdgB // yggU // yggT // yggS	hemW // rdgB // yggU // yggT // yggS
ttdABT	ttdT // ttdA // ttdB	ttdT // ttdA // ttdB
yjiT	yjiT	yjiT
rfaYZ	waaZ // waaY	waaZ // waaY
thyA	thyA	thyA
bcsBZ	bcsZ // bcsB	bcsZ // bcsB
hscC	hscC	hscC
yeaE	yeaE	yeaE
ldrB	ldrB	ldrB
rpsU-dnaG-rpoD	rpsU // dnaG // rpoD	rpsU // dnaG // rpoD
ygfF	ygfF	ygfF
insB7	insB7	insB7
relA	relA	relA
fbp	fbp	fbp
rna	rna	rna
ydiZ	ydiZ	ydiZ
mak	mak	mak
rnt-lhr	rnt // lhr	rnt // lhr
ygeY	ygeY	ygeY
bdcR	bdcR	bdcR
creD	creD	creD
mepS	mepS	mepS
ybcV	ybcV	ybcV
dut-slmA	slmA // dut	slmA // dut
fumD	fumD	fumD
ompX	ompX	ompX
yhdT-panF-prmA	yhdT // panF // prmA	yhdT // panF // prmA
yqeG	yqeG	yqeG
bsmA	bsmA	bsmA
fre	fre	fre
fabF	fabF	fabF
ybcF // ylbF // ylbE // fdrA	ybcF // ylbF // ylbE // fdrA	ybcF // ylbF // ylbE // fdrA
metR	metR	metR
hdhA	hdhA	hdhA
envR	envR	envR
ygdG	ygdG	ygdG
modABC	modA // modB // modC	modA // modB // modC
ghoT // ghoS	ghoT // ghoS	ghoT // ghoS
dam-rpe-gph-trpS	trpS // gph // rpe // dam	trpS // gph // rpe // dam
talA	talA	talA
tnaC	tnaC	tnaC
maa	maa	maa
talB	talB	talB
dicB-ydfDE-insD-intQ	intQ // insD7 // ydfE // ydfD // dicB	intQ // insD7 // ydfE // ydfD // dicB
bioH	bioH	bioH
ygbN	ygbN	ygbN
hdeAB-yhiD	yhiD // hdeB // hdeA	yhiD // hdeB // hdeA
aphA	aphA	aphA
yjeFE-amiB-mutL-miaA-hfq-hflXKC	hflC // hflK // hflX // hfq // miaA // mutL // amiB // tsaE // nnr	hflC // hflK // hflX // hfq // miaA // mutL // amiB // tsaE // nnr
rne	rne	rne
yjiY	btsT	btsT
panE // yajL	panE // yajL	panE // yajL
rpsT	rpsT	rpsT
ydfJ	ydfJ	ydfJ
yghZ	gpr	gpr
ileY	ileY	ileY
exbBD	exbD // exbB	exbD // exbB
nfi // hemE // nudC	nfi // hemE // nudC	nfi // hemE // nudC
rpmH-rnpA	rnpA // rpmH	rnpA // rpmH
cspE	cspE	cspE
sdiA	sdiA	sdiA
yaiX	yaiX	yaiX
ydeP	ydeP	ydeP
lsrK	lsrK	lsrK
yfeR	yfeR	yfeR
intA	intA	intA
chaBC	chaB // chaC	chaB // chaC
yiiM	yiiM	yiiM
nac	nac	nac
pspBCDE	pspE // pspD // pspC // pspB	pspE // pspD // pspC // pspB
yciT	yciT	yciT
ykgG // ykgF // ykgE	ykgG // ykgF // ykgE	ykgG // ykgF // ykgE
glk	glk	glk
yddE	yddE	yddE
yegD	yegD	yegD
yfhH	yfhH	yfhH
acrAB	acrA // acrB	acrA // acrB
bipA	bipA	bipA
pqiABC	pqiC // pqiB // pqiA	pqiC // pqiB // pqiA
rrlB-rrfB	rrfB // rrlB	rrfB // rrlB
sdiA	sdiA	sdiA
yagK	yagK	yagK
waaA	waaA	waaA
rlhA	rlhA	rlhA
eamA	eamA	eamA
ndk	ndk	ndk
glpTQ	glpQ // glpT	glpQ // glpT
rarD	rarD	rarD
paaABCDEFGHIJK	paaK // paaJ // paaI // paaH // paaG // paaF // paaE // paaD // paaC // paaB // paaA	paaK // paaJ // paaI // paaH // paaG // paaF // paaE // paaD // paaC // paaB // paaA
gcvP	gcvP	gcvP
ydcSTUV-patD	patD // ydcT // ydcU // ydcV // ydcS	patD // ydcT // ydcU // ydcV // ydcS
prfH // ykfJ	prfH // ykfJ	prfH // ykfJ
lepAB	lepA // lepB	lepA // lepB
ydbD	ydbD	ydbD
ycgJ	ycgJ	ycgJ
eutH // eutA	eutH // eutA	eutH // eutA
nhaAR	nhaR // nhaA	nhaR // nhaA
cbrC	cbrC	cbrC
cmr	mdfA	mdfA
rrsE-gltV-rrlE-rrfE	rrfE // rrlE // gltV // rrsE	rrfE // rrlE // gltV // rrsE
dsbC	dsbC	dsbC
dkgB	dkgB	dkgB
rnhA	rnhA	rnhA
trkG	trkG	trkG
ybjD	ybjD	ybjD
ypeC	ypeC	ypeC
livKHMGF	livF // livG // livM // livH // livK	livF // livG // livM // livH // livK
yicN	yicN	yicN
arcA	arcA	arcA
nagC	nagC	nagC
dgkA	dgkA	dgkA
mrcB	mrcB	mrcB
aceEF	aceF // aceE	aceF // aceE
ycjY	ycjY	ycjY
yphH	yphH	yphH
intS	intS	intS
mglBAC	mglC // mglA // mglB	mglC // mglA // mglB
grxC	grxC	grxC
mobAB	mobB // mobA	mobB // mobA
csgDEFG	csgG // csgF // csgE // csgD	csgG // csgF // csgE // csgD
pstB-phoU	phoU // pstB	phoU // pstB
sgrR-sroA-thiBPQ	sgrR // sroA // thiB // thiP // thiQ	sgrR // sroA // thiB // thiP // thiQ
uvrC	uvrC	uvrC
yciK // btuR	yciK // btuR	yciK // btuR
ymfI	ymfI	ymfI
yfbV	yfbV	yfbV
fdhF	fdhF	fdhF
ghrB	ghrB	ghrB
caiF	caiF	caiF
hypF	hypF	hypF
prpBCDE	prpE // prpD // prpC // prpB	prpE // prpD // prpC // prpB
yaaX	yaaX	yaaX
katE	katE	katE
ymgE	ymgE	ymgE
yjgD	rraB	rraB
yfaY	yfaY	yfaY
fucAO	fucO // fucA	fucO // fucA
yhiS	yhiS	yhiS
leuU	leuU	leuU
mreBCD	mreD // mreC // mreB	mreD // mreC // mreB
ryhB	ryhB	ryhB
rrsG-gltW-rrlG-rrfG	rrfG // rrlG // gltW // rrsG	rrfG // rrlG // gltW // rrsG
pyrG-eno	eno // pyrG	eno // pyrG
ycgZ	ycgZ	ycgZ
yidX	yidX	yidX
pdeN	pdeN	pdeN
crp	crp	crp
yhhQ	yhhQ	yhhQ
ileX	ileX	ileX
mnmA	mnmA	mnmA
copA	copA	copA
dsbA	dsbA	dsbA
tisB	tisB	tisB
ymfA // ycfZ	ymfA // ycfZ	ymfA // ycfZ
yhhM	yhhM	yhhM
mdtQ	mdtQ	mdtQ
sucABCD	sucA // sucB // sucC // sucD	sucA // sucB // sucC // sucD
hofQ	hofQ	hofQ
rcsA	rcsA	rcsA
ligT	thpR	thpR
gyrB	gyrB	gyrB
gspAB	gspB // gspA	gspB // gspA
mutY-yggX-mltC	mltC // yggX // mutY	mltC // yggX // mutY
yceJI	yceJ // yceI	yceJ // yceI
ybhQ	ybhQ	ybhQ
yehD // yehC // yehB // yehA	yehD // yehC // yehB // yehA	yehD // yehC // yehB // yehA
phoE	phoE	phoE
yhdV	yhdV	yhdV
glgCAP	glgP // glgA // glgC	glgP // glgA // glgC
yqgB	yqgB	yqgB
mhpABCDFE	mhpF // mhpE // mhpD // mhpC // mhpB // mhpA	mhpF // mhpE // mhpD // mhpC // mhpB // mhpA
yejO	yejO	yejO
mutM	mutM	mutM
gnsA // ymcE	gnsA // ymcE	gnsA // ymcE
yaiT	yaiT	yaiT
wcaCDEF-gmd-fcl-gmm-wcaI-cpsBG-wcaJ-wzxC	wcaC // wcaD // wcaE // wcaF // gmd // fcl // gmm // wcaI // cpsB // cpsG // wcaJ // wzxC	wcaC // wcaD // wcaE // wcaF // gmd // fcl // gmm // wcaI // cpsB // cpsG // wcaJ // wzxC
uvrB	uvrB	uvrB
yhcC	yhcC	yhcC
endA	endA	endA
ygdD	ygdD	ygdD
gabDTP	gabP // gabT // gabD	gabP // gabT // gabD
ycaC	ycaC	ycaC
pdxB-usg-truA-dedA	dedA // truA // usg // pdxB	dedA // truA // usg // pdxB
elfA	elfA	elfA
ushA	ushA	ushA
yeeP	yeeP	yeeP
hflD-purB	purB // hflD	purB // hflD
yraQ	yraQ	yraQ
rpsU-dnaG-rpoD	rpsU // dnaG // rpoD	rpsU // dnaG // rpoD
yrbG-kdsD	kdsD // yrbG	kdsD // yrbG
fxsA	fxsA	fxsA
lon	lon	lon
aat	aat	aat
sraG	sraG	sraG
yedS	yedS	yedS
malEFG	malG // malF // malE	malG // malF // malE
ygjR	ygjR	ygjR
dnaKJ	tpke11 // dnaK // dnaJ	tpke11 // dnaK // dnaJ
thrS-infC-rpmI-rplT-pheMST-ihfA	ihfA // pheT // pheS // pheM // rplT // rpmI // infC // thrS	ihfA // pheT // pheS // pheM // rplT // rpmI // infC // thrS
pykF	pykF	pykF
nrdDG	nrdG // nrdD	nrdG // nrdD
ybiV	ybiV	ybiV
rfaH	rfaH	rfaH
yecJ	yecJ	yecJ
fnr	fnr	fnr
ubiK	ubiK	ubiK
htpG	htpG	htpG
setB	setB	setB
ynjH	ynjH	ynjH
gntR	gntR	gntR
ybhJ	ybhJ	ybhJ
ydiU	ydiU	ydiU
sdsR	sdsR	sdsR
argI	argI	argI
dkgAp // dkgA	dkgA	dkgA
ackA	ackA	ackA
yjjJ	yjjJ	yjjJ
rraB	rraB	rraB
yaiS	yaiS	yaiS
ybgIJKL-nei	pxpA // nei // pxpC // pxpB // ybgI	pxpA // nei // pxpC // pxpB // ybgI
abrB	abrB	abrB
ybfHG	ybfG	ybfG
ybfQ	ybfQ	ybfQ
yeaX	yeaX	yeaX
dnaTC	dnaC // dnaT	dnaC // dnaT
yggI	yggI	yggI
thiCEFSGH	thiS // thiH // thiG // thiF // thiE // thiC	thiS // thiH // thiG // thiF // thiE // thiC
mdtM // yjiN	mdtM // yjiN	mdtM // yjiN
pepA	pepA	pepA
yqaE-kbp	kbp // yqaE	kbp // yqaE
bssS	bssS	bssS
leuS // lptE // holA // nadD // cobC	leuS // lptE // holA // nadD // cobC	leuS // lptE // holA // nadD // cobC
yeaC	yeaC	yeaC
kdgR	kdgR	kdgR
rpsLG-fusA-tufA	tufA // fusA // rpsG // rpsL	tufA // fusA // rpsG // rpsL
sdhE-ygfX	sdhE // ygfX	sdhE // ygfX
insN-2	insO	insO
tolC-ygiBC	ygiC // ygiB // tolC	ygiC // ygiB // tolC
galETK	galK // galT // galE	galK // galT // galE
ydhP	ydhP	ydhP
ybdO	ybdO	ybdO
nlpC	nlpC	nlpC
mdtK	mdtK	mdtK
rfaDFCL	rfaD // waaF // waaC // waaL	rfaD // waaF // waaC // waaL
ygeR	ygeR	ygeR
ridA	ridA	ridA
gpt	gpt	gpt
degS	degS	degS
ylcG // rusA // ybcO // ninE // ybcN	ylcG // rusA // ybcO // ninE // ybcN	ylcG // rusA // ybcO // ninE // ybcN
rimJ	rimJ	rimJ
ydhS	ydhS	ydhS
galR	galR	galR
rimP-nusA-infB	rimP // infB // nusA	rimP // infB // nusA
kduD	kduD	kduD
yjfJ // yjfI	yjfJ // yjfI	yjfJ // yjfI
yheO-tusDCB	tusB // tusC // tusD // yheO	tusB // tusC // tusD // yheO
nemRA-gloA	gloA // nemA // nemR	gloA // nemA // nemR
ybbP // ybbA	ybbP // ybbA	ybbP // ybbA
yggE	yggE	yggE
folM // ydgI	folM // ydgI	folM // ydgI
dsrB	dsrB	dsrB
syd	syd	syd
menFD-yfbB-menBCE	menE // menC // menB // menH // menD // menF	menE // menC // menB // menH // menD // menF
adiC	adiC	adiC
aroKB-damX-dam-rpe-gph-trpS	trpS // gph // rpe // dam // damX // aroB // aroK	trpS // gph // rpe // dam // damX // aroB // aroK
glk	glk	glk
hisL	hisL	hisL
ybaA	ybaA	ybaA
pgk	pgk	pgk
dicA	dicA	dicA
amiC	amiC	amiC
pphB	pphB	pphB
glgS	glgS	glgS
dusA	dusA	dusA
acnA	ymiC // acnA	ymiC // acnA
ltaE-ybjT	ybjT // ltaE	ybjT // ltaE
rmf	rmf	rmf
yajD	yajD	yajD
pagP	pagP	pagP
ydfH	ydfH	ydfH
yggR	yggR	yggR
pinH	pinH	pinH
dppABCDF	dppF // dppD // dppC // dppB // dppA	dppF // dppD // dppC // dppB // dppA
yijD // fabR	yijD // fabR	yijD // fabR
proVWX	proX // proW // proV	proX // proW // proV
yjjQ-bglJ	bglJ // yjjQ	bglJ // yjjQ
ddpXABCDF	ddpF // ddpD // ddpC // ddpB // ddpA // ddpX	ddpF // ddpD // ddpC // ddpB // ddpA // ddpX
frmR // frmA // frmB	frmR // frmA // frmB	frmR // frmA // frmB
nohA-stfQ-tfaQ	tfaQ // stfQ // nohA	tfaQ // stfQ // nohA
yneL	yneL	yneL
yfdY	yfdY	yfdY
nadK	nadK	nadK
btuCED	btuD // btuE // btuC	btuD // btuE // btuC
yiiG	yiiG	yiiG
rtcBA	rtcA // rtcB	rtcA // rtcB
alsBACE	alsE // alsC // alsA // alsB	alsE // alsC // alsA // alsB
yjhC // yjhB	yjhC // yjhB	yjhC // yjhB
rclB // rclC	rclB // rclC	rclB // rclC
tktB	tktB	tktB
yedA	yedA	yedA
yphG	yphG	yphG
accA	accA	accA
yihD	yihD	yihD
tpx	tpx	tpx
rrlH-rrfH	rrfH // rrlH	rrfH // rrlH
msrB	msrB	msrB
yagH // yagG	yagH // yagG	yagH // yagG
bdm-sra	sra // bdm	sra // bdm
ydcK	ydcK	ydcK
yfgI // yfgH	yfgI // yfgH	yfgI // yfgH
treBC	treC // treB	treC // treB
yzcX	yzcX	yzcX
hupB	hupB	hupB
fucR	fucR	fucR
mpaA	mpaA	mpaA
lafU	lafU	lafU
argE	argE	argE
insI2	insI2	insI2
ycfQ	comR	comR
yffN // yffM	yffN // yffM	yffN // yffM
codBA	codB // codA	codB // codA
yidZ	yidZ	yidZ
glpGR	glpR // glpG	glpR // glpG
hslR-hslO	hslO // hslR	hslO // hslR
yggN	yggN	yggN
yaeF	yaeF	yaeF
rpsO-pnp	pnp // rpsO	pnp // rpsO
racR	racR	racR
ytjC	ytjC	ytjC
ypdC // pyrR // pyrS	ypdC // pyrR // pyrS	ypdC // pyrR // pyrS
lrp	lrp	lrp
setC	setC	setC
arcA	arcA	arcA
potFGHI	potI // potH // potG // potF	potI // potH // potG // potF
arrS	arrS	arrS
yadC	yadC	yadC
ssuEADCB	ssuB // ssuC // ssuD // ssuA // ssuE	ssuB // ssuC // ssuD // ssuA // ssuE
ompG	ompG	ompG
yodD	yodD	yodD
yfcZ	yfcZ	yfcZ
fepDGC	fepC // fepG // fepD	fepC // fepG // fepD
yibL	yibL	yibL
eda	eda	eda
ryfD	ryfD	ryfD
luxS	luxS	luxS
djlA	djlA	djlA
pabA	pabA	pabA
yciGFE	yciE // yciF // yciG	yciE // yciF // yciG
ykgL	ykgL	ykgL
yfbR	yfbR	yfbR
dsdC	dsdC	dsdC
yhjY	yhjY	yhjY
putP	putP	putP
cyaA	cyaA	cyaA
argR	argR	argR
chpSB	chpB // chpS	chpB // chpS
glnS	glnS	glnS
nhaB	nhaB	nhaB
yjfZ	yjfZ	yjfZ
ypaA // rpnE	ypaA // rpnE	ypaA // rpnE
malXY	malX // malY	malX // malY
prlC-yhiQ	prlC // rsmJ	prlC // rsmJ
serV-argVYZQ	argQ // argZ // argY // argV // serV	argQ // argZ // argY // argV // serV
cynTS	cynS // cynT	cynS // cynT
patA	patA	patA
rrsC-gltU-rrlC-rrfC	rrfC // rrlC // gltU // rrsC	rrfC // rrlC // gltU // rrsC
amn	amn	amn
ycgX	ycgX	ycgX
yidP	yidP	yidP
yeiQ	yeiQ	yeiQ
betT	betT	betT
yrhB	yrhB	yrhB
asnV	asnV	asnV
rcsDB	rcsB // rcsD	rcsB // rcsD
trxA	trxA	trxA
nrdHIEF	nrdH // nrdI // nrdF // nrdE	nrdH // nrdI // nrdF // nrdE
entS	entS	entS
ycfT	ycfT	ycfT
yhgN	yhgN	yhgN
pbpG	pbpG	pbpG
araJ	araJ	araJ
yhfL	yhfL	yhfL
ptsHI-crr	ptsH // ptsI // crr	ptsH // ptsI // crr
yraM	lpoA	lpoA
fiu	fiu	fiu
ydhIJK	ydhK // ydhJ // ydhI	ydhK // ydhJ // ydhI
pspG	pspG	pspG
ymdB-clsC	clsC // ymdB	clsC // ymdB
dtpD	dtpD	dtpD
rcnR	rcnR	rcnR
rpoH	rpoH	rpoH
csrD	csrD	csrD
cadBA	cadA // cadB	cadA // cadB
yjhA	nanC	nanC
gadX	gadX	gadX
greA	greA	greA
ynfEFGH-dmsD	dmsD // ynfH // ynfG // ynfF // ynfE	dmsD // ynfH // ynfG // ynfF // ynfE
gfcB // gfcC // gfcD	gfcB // gfcC // gfcD	gfcB // gfcC // gfcD
yagU	yagU	yagU
ugd	ugd	ugd
trpLEDCBA	trpA // trpB // trpC // trpD // trpE // trpL	trpA // trpB // trpC // trpD // trpE // trpL
ibaG	ibaG	ibaG
tsx	tsx	tsx
yeiI	yeiI	yeiI
inaA	inaA	inaA
fusA-tufA	tufA // fusA	tufA // fusA
ldtD	ldtD	ldtD
tp2	tp2	tp2
insH6	insH6	insH6
oxyR	oxyR	oxyR
sohA-yhaV	yhaV // prlF	yhaV // prlF
uspA	uspA	uspA
yqjA-mzrA	mzrA // yqjA	mzrA // yqjA
dcuC	dcuC	dcuC
gntT	gntT	gntT
ybjS	ybjS	ybjS
ybjX	ybjX	ybjX
yodC	yodC	yodC
kdpFABC	kdpF // kdpC // kdpB // kdpA	kdpF // kdpC // kdpB // kdpA
rlmG	rlmG	rlmG
fliAZY	tcyJ // fliZ // fliA	tcyJ // fliZ // fliA
lsp-fkpB-ispH	ispH // fkpB // lspA	ispH // fkpB // lspA
fabB	fabB	fabB
ompA	ompA	ompA
rhtA	rhtA	rhtA
rdlA	rdlA	rdlA
argS	argS	argS
dmsABC	dmsA // dmsB // dmsC	dmsA // dmsB // dmsC
nudF // yqiB // cpdA // yqiA // parE	nudF // yqiB // cpdA // yqiA // parE	nudF // yqiB // cpdA // yqiA // parE
osmE	osmE	osmE
C0614	C0614	C0614
fnrS	fnrS	fnrS
alsRBACE	alsE // alsC // alsA // alsB // alsR	alsE // alsC // alsA // alsB // alsR
acrZ	acrZ	acrZ
appY	appY	appY
rsmF	rsmF	rsmF
araC	araC	araC
yghX	yghX	yghX
pflB	pflB	pflB
ftsAZ	ftsZ // ftsA	ftsZ // ftsA
azuC	azuC	azuC
imp-surA-pdxA	pdxA // surA // lptD	pdxA // surA // lptD
hcp-hcr-poxB	poxB // hcr // hcp	poxB // hcr // hcp
rssAB	rssB // rssA	rssB // rssA
ybfA	ybfA	ybfA
argP	argP	argP
pdxH-tyrS-pdxY	pdxY // tyrS // pdxH	pdxY // tyrS // pdxH
surA-pdxA-rsmA-apaGH	apaH // apaG // rsmA // pdxA // surA	apaH // apaG // rsmA // pdxA // surA
yjiJ	yjiJ	yjiJ
fadR	fadR	fadR
accBC	accC // accB	accC // accB
dcuSR	dcuR // dcuS	dcuR // dcuS
ybeD	ybeD	ybeD
ydjE	ydjE	ydjE
intG	intG	intG
rpsB-tsf	tff // rpsB // tsf	tff // rpsB // tsf
uacT	uacT	uacT
yjgX	yjgX	yjgX
mdtEF	mdtF // mdtE	mdtF // mdtE
galE	galE	galE
ybdD	ybdD	ybdD
ppsR	ppsR	ppsR
mrcA	mrcA	mrcA
pspABCDE	pspA // pspB // pspC // pspD // pspE	pspA // pspB // pspC // pspD // pspE
ygeP	ygeP	ygeP
yjfF // ytfT // ytfR // ytfQ	yjfF // ytfT // ytfR // ytfQ	yjfF // ytfT // ytfR // ytfQ
artPIQM	artM // artQ // artI // artP	artM // artQ // artI // artP
ssnA	ssnA	ssnA
ybfE	ybfE	ybfE
mepH	mepH	mepH
guaC	guaC	guaC
tas	tas	tas
rsgA	rsgA	rsgA
pyrG-eno	eno // pyrG	eno // pyrG
agrB	agrB	agrB
cueR	cueR	cueR
gloA	gloA	gloA
ydgD	ydgD	ydgD
ddlA	ddlA	ddlA
ygcE // yqcE	ygcE // yqcE	ygcE // yqcE
kdtA-coaD	waaA // coaD	waaA // coaD
yjdN	yjdN	yjdN
tgt-yajC	yajC // tgt	yajC // tgt
flu	flu	flu
leuL	leuL	leuL
decR	decR	decR
tpiA	tpiA	tpiA
relB // relE	relB // relE	relB // relE
acpH	acpH	acpH
csrAp3 // csrA	csrA	csrA
fliLMNOPQR	fliL // fliM // fliN // fliO // fliP // fliQ // fliR	fliL // fliM // fliN // fliO // fliP // fliQ // fliR
dgkA	dgkA	dgkA
xapR	xapR	xapR
acrB	acrB	acrB
gapA	gapA	gapA
ykiA	ykiA	ykiA
rob	rob	rob
dgcZ	dgcZ	dgcZ
ygdI	ygdI	ygdI
yfjW	yfjW	yfjW
dnaAN-recF	recF // dnaN // dnaA	recF // dnaN // dnaA
frwB // frwC	frwB // frwC	frwB // frwC
paaXY	paaY // paaX	paaY // paaX
miaA-hfq-hflXKC	hflC // hflK // hflX // hfq // miaA	hflC // hflK // hflX // hfq // miaA
rybA-mntS	rybA // mntS	rybA // mntS
yahM	yahM	yahM
gcl-hyi-glxR-ybbVW-allB-ybbY-glxK	glxK // ybbY // allB // ybbW // glxR // hyi // gcl	glxK // ybbY // allB // ybbW // glxR // hyi // gcl
ydeN	ydeN	ydeN
yfbK	yfbK	yfbK
ffh	ffh	ffh
atpIBEFHAGDC	atpC // atpD // atpG // atpA // atpH // atpF // atpE // atpB // atpI	atpC // atpD // atpG // atpA // atpH // atpF // atpE // atpB // atpI
yiiE	yiiE	yiiE
dnaAN-recF	recF // dnaN // dnaA	recF // dnaN // dnaA
rutR	rutR	rutR
gntU terminator // gntU	gntU	gntU
ykgMO	ykgM // ykgO	ykgM // ykgO
kdgK	kdgK	kdgK
yncH	yncH	yncH
yebQ	yebQ	yebQ
yphA	yphA	yphA
edd-eda	eda // edd	eda // edd
ubiD	ubiD	ubiD
poxB	poxB	poxB
ubiX	ubiX	ubiX
rfaDFCL	waaL // waaC // waaF // rfaD	waaL // waaC // waaF // rfaD
insA2 // insB2 // insAB2 // afuB // afuC	insA2 // insB2 // insAB2 // afuB // afuC	insA2 // insB2 // insAB2 // afuB // afuC
uvrB	uvrB	uvrB
opgD	opgD	opgD
ydbJ	ydbJ	ydbJ
ypfJ // tmcA	ypfJ // tmcA	ypfJ // tmcA
ftsQAZ	ftsQ // ftsA // ftsZ	ftsQ // ftsA // ftsZ
rhlB	rhlB	rhlB
hupA	hupA	hupA
pspE	pspE	pspE
phoQ	phoQ	phoQ
dinJ-yafQ	dinJ // yafQ	dinJ // yafQ
ilvIH	ilvH // ilvI	ilvH // ilvI
tynA	tynA	tynA
yccX	yccX	yccX
eutB // eutC // eutL // eutK // eutR	eutB // eutC // eutL // eutK // eutR	eutB // eutC // eutL // eutK // eutR
nadB	nadB	nadB
yidB	yidB	yidB
gadBC	gadC // gadB	gadC // gadB
holC-valS	valS // holC	valS // holC
ftsQ	ftsQ	ftsQ
tilS	tilS	tilS
pheLA	pheA // pheL	pheA // pheL
racC	racC	racC
ytfA	ytfA	ytfA
oxc	oxc	oxc
thrLABC	thrL // thrA // thrB // thrC	thrL // thrA // thrB // thrC
xanP	xanP	xanP
arcA	arcA	arcA
yiaKLMNO-lyx-sgbHUE	sgbE // sgbU // sgbH // lyxK // yiaO // yiaN // yiaM // yiaL // yiaK	sgbE // sgbU // sgbH // lyxK // yiaO // yiaN // yiaM // yiaL // yiaK
kdsC-lptCAB	lptB // lptA // lptC // kdsC	lptB // lptA // lptC // kdsC
yadH // yadG	yadH // yadG	yadH // yadG
tesA-ybbO	ybbO // tesA	ybbO // tesA
puuDRCBE	puuE // puuB // puuC // puuR // puuD	puuE // puuB // puuC // puuR // puuD
yoaH	yoaH	yoaH
prmB // aroC // mepA // yfcA // epmC // yfcL	prmB // aroC // mepA // yfcA // epmC // yfcL	prmB // aroC // mepA // yfcA // epmC // yfcL
pps	ppsA	ppsA
yibJ	yibJ	yibJ
msrA	msrA	msrA
symR	symR	symR
yciE	yciE	yciE
rihC	rihC	rihC
gltX	gltX	gltX
yciI	yciI	yciI
yjjN	lgoD	lgoD
yfbO	yfbO	yfbO
cysDNC	cysC // cysN // cysD	cysC // cysN // cysD
rdlD	rdlD	rdlD
aldA	aldA	aldA
crp	crp	crp
yiiS-uspD	uspD // yiiS	uspD // yiiS
gdhA	gdhA	gdhA
cspD	cspD	cspD
ycgM	ycgM	ycgM
queG	queG	queG
ftp	ftp	ftp
nupG	nupG	nupG
glyW-cysT-leuZ	3'ETS<sup><i>leuZ</i></sup> // leuZ // cysT // glyW	3'ETSleuZ // leuZ // cysT // glyW
gspAB	gspB // gspA	gspB // gspA
recF	recF	recF
rrsA-ileT-alaT-rrlA-rrfA	rrfA // rrlA // alaT // ileT // rrsA	rrfA // rrlA // alaT // ileT // rrsA
pyrF-yciH	yciH // pyrF	yciH // pyrF
mcrA	mcrA	mcrA
yicS	yicS	yicS
psuT	psuT	psuT
asnC	asnC	asnC
yhhW	yhhW	yhhW
metZWV	metZ // metW // metV	metZ // metW // metV
rsmB	rsmB	rsmB
hemF	hemF	hemF
astCADBE	astE // astB // astD // astA // astC	astE // astB // astD // astA // astC
yidQ	yidQ	yidQ
ycfP // nagZ // thiK // lpoB // ycfL // hinT	ycfP // nagZ // thiK // lpoB // ycfL // hinT	ycfP // nagZ // thiK // lpoB // ycfL // hinT
yhbY	yhbY	yhbY
btsS // btsR	btsS // btsR	btsS // btsR
slp-dctR	dctR // slp	dctR // slp
yheU // yheT // yheS	yheU // yheT // yheS	yheU // yheT // yheS
ptsHI-crr	ptsH // ptsI // crr	ptsH // ptsI // crr
C0362	C0362	C0362
topA	topA	topA
essD-ybcS-rzpD	rzpD // rrrD // essD	rzpD // rrrD // essD
arcB	arcB	arcB
ycdY // ycdX	ycdY // ycdX	ycdY // ycdX
ybeL	ybeL	ybeL
yegW	yegW	yegW
fadL	fadL	fadL
aaeXAB	aaeX // aaeA // aaeB	aaeX // aaeA // aaeB
ppiA	ppiA	ppiA
yfhG	qseG	qseG
mfd	mfd	mfd
htrG-cca	cca // ygiM	cca // ygiM
osmF-yehYXW	yehW // yehX // yehY // osmF	yehW // yehX // yehY // osmF
tusE	tusE	tusE
yafU	yafU	yafU
yeeZ	yeeZ	yeeZ
sodA	sodA	sodA
ispB	ispB	ispB
clpA	clpA	clpA
yadN	yadN	yadN
pspF	pspF	pspF
uidABC	uidC // uidB // uidA	uidC // uidB // uidA
ycaQ // lpxK // msbA // ycaI	ycaQ // lpxK // msbA // ycaI	ycaQ // lpxK // msbA // ycaI
tesB	tesB	tesB
yeeN	yeeN	yeeN
ompA	ompA	ompA
cyuP // cyuA	cyuP // cyuA	cyuP // cyuA
lysU	lysU	lysU
modABC	modC // modB // modA	modC // modB // modA
cspA	cspA	cspA
gapA	gapA	gapA
ybjL	ybjL	ybjL
tusA	tusA	tusA
yedN	yedN	yedN
ivbL-ilvBN	ilvN // ilvB // ivbL	ilvN // ilvB // ivbL
ygjK // ygjJ	ygjK // ygjJ	ygjK // ygjJ
grpE	grpE	grpE
ftsZ	ftsZ	ftsZ
pgk	pgk	pgk
lacZYA	lacA // lacY // lacZ	lacA // lacY // lacZ
ybiX	ybiX	ybiX
proC	proC	proC
lpxM	lpxM	lpxM
cyaA	cyaA	cyaA
ygiW	ygiW	ygiW
stpA	stpA	stpA
yghO	yghO	yghO
xdhABC	xdhC // xdhB // xdhA	xdhC // xdhB // xdhA
rpiB	rpiB	rpiB
zitB	zitB	zitB
metY	metY	metY
proQ // prc	proQ // prc	proQ // prc
menA-rraA	rraA // menA	rraA // menA
pitB	pitB	pitB
focA-pflB	pflB // focA	pflB // focA
prfC	prfC	prfC
ivbL-ilvBN-uhpABC	uhpC // uhpB // uhpA // ilvN // ilvB // ivbL	uhpC // uhpB // uhpA // ilvN // ilvB // ivbL
ahpCF	ahpF // ahpC	ahpF // ahpC
rpoE-rseABC	rseD // rseC // rseB // rseA // rpoE	rseD // rseC // rseB // rseA // rpoE
rssB	rssB	rssB
chiQ	chiQ	chiQ
yeaQ	yeaQ	yeaQ
pheM	pheM	pheM
yacC-speED	yacC // speD // speE	yacC // speD // speE
mscS	mscS	mscS
nanS	nanS	nanS
gadW	gadW	gadW
ascB	ascB	ascB
hypABCDE-fhlA	fhlA // hypE // hypD // hypC // hypB // hypA	fhlA // hypE // hypD // hypC // hypB // hypA
lipA	lipA	lipA
ynjE	ynjE	ynjE
insH-8	insH8	insH8
rpmH-rnpA	rpmH // rnpA	rpmH // rnpA
xdhD // ygfM	xdhD // ygfM	xdhD // ygfM
insD6 // insC6 // insCD6	insD6 // insC6 // insCD6	insD6 // insC6 // insCD6
pstB-phoU	phoU // pstB	phoU // pstB
micL	micL	micL
yoeA	yoeA	yoeA
ybdJ	ybdJ	ybdJ
ydiM	ydiM	ydiM
narP	narP	narP
ppk-ppx	ppx // ppk	ppx // ppk
pbl	pbl	pbl
ytfI	ytfI	ytfI
groL	groL	groL
feaR	feaR	feaR
exoD	exoD	exoD
insK	insK	insK
sodC	sodC	sodC
gltS	gltS	gltS
mutH	mutH	mutH
nikABCDER	nikR // nikA // nikB // nikC // nikD // nikE	nikR // nikA // nikB // nikC // nikD // nikE
epmA	epmA	epmA
rpoS	rpoS	rpoS
frr	frr	frr
hemH	hemH	hemH
msyB	msyB	msyB
ynfK	ynfK	ynfK
dacB	dacB	dacB
ygcS	ygcS	ygcS
hybOABCDEFG	hybO // hybG // hybF // hybE // hybD // hybC // hybB // hybA	hybO // hybG // hybF // hybE // hybD // hybC // hybB // hybA
mdtN // mdtO // mdtP	mdtN // mdtO // mdtP	mdtN // mdtO // mdtP
phoH	phoH	phoH
pykA	pykA	pykA
bluF	bluF	bluF
queC	queC	queC
glnQ	glnQ	glnQ
ydfU // ydfT	ydfU // ydfT	ydfU // ydfT
dcuD	dcuD	dcuD
ygaH // ygaZ	ygaH // ygaZ	ygaH // ygaZ
flgBCDEFGHIJ	flgB // flgC // flgD // flgE // flgF // flgG // flgH // flgI // flgJ	flgB // flgC // flgD // flgE // flgF // flgG // flgH // flgI // flgJ
yjbH // yjbG // yjbF	yjbH // yjbG // yjbF	yjbH // yjbG // yjbF
mlc	mlc	mlc
ampH	ampH	ampH
leuO	leuO	leuO
iraP	iraP	iraP
rstAB	rstB // rstA	rstB // rstA
yneJ	yneJ	yneJ
yfjH	yfjH	yfjH
yfjT // yfjS // ypjK // yfjR	yfjT // yfjS // ypjK // yfjR	yfjT // yfjS // ypjK // yfjR
dapA-nlpB	bamC // dapA	bamC // dapA
yijE	yijE	yijE
torYZ	torZ // torY	torZ // torY
mutL-miaA-hfq-hflXKC	hflC // hflK // hflX // hfq // miaA // mutL	hflC // hflK // hflX // hfq // miaA // mutL
csrA	csrA	csrA
yahJ // yahI	yahJ // yahI	yahJ // yahI
polB	polB	polB
pqqL	pqqL	pqqL
yfaH	yfaH	yfaH
raiA	raiA	raiA
artPIQM	artM // artQ // artI // artP	artM // artQ // artI // artP
yihUTS	yihU // yihT // yihS	yihU // yihT // yihS
gadAX	gadX // gadA	gadX // gadA
glcBA	glcA // glcB	glcA // glcB
rpsI terminator // rpsI	rpsI	rpsI
ecpBCDE	ecpB // ecpC // ecpD // ecpE	ecpB // ecpC // ecpD // ecpE
moaBCDE	moaE // moaD // moaC // moaB	moaE // moaD // moaC // moaB
curA	curA	curA
yeaL	yeaL	yeaL
suhB	suhB	suhB
serA	serA	serA
rmuC	rmuC	rmuC
ilvLXG_1G_2MEDA	ilvX // ilvG // ilvA // ilvD // ilvE // ilvM // ilvL	ilvX // ilvG // ilvA // ilvD // ilvE // ilvM // ilvL
ybjN	ybjN	ybjN
cspF	cspF	cspF
insN-1p // insO1 // insI1 // insN	insI1 // insN	insI1 // insN
hcp-hcr	hcr // hcp	hcr // hcp
mokB	mokB	mokB
ycjW	ycjW	ycjW
narQ	narQ	narQ
wza-wzb-wzc-wcaAB	wcaB // wcaA // wzc // wzb // wza	wcaB // wcaA // wzc // wzb // wza
ppiC	ppiC	ppiC
garPLRK-rnpB	rnpB // garK // garR // garL // garP	rnpB // garK // garR // garL // garP
dksA-yadB	gluQ // dksA	gluQ // dksA
bamC	bamC	bamC
gmhA	gmhA	gmhA
nanCM	nanM // nanC	nanM // nanC
ompN	ompN	ompN
ycbX	ycbX	ycbX
murR	murR	murR
metC	metC	metC
dgoRKADT	dgoR // dgoK // dgoA // dgoD // dgoT	dgoR // dgoK // dgoA // dgoD // dgoT
napFDAGHBC-ccmABCDEFGH	ccmH // ccmG // ccmF // ccmE // ccmD // ccmC // ccmB // ccmA // napC // napB // napH // napG // napA // napD // napF	ccmH // ccmG // ccmF // ccmE // ccmD // ccmC // ccmB // ccmA // napC // napB // napH // napG // napA // napD // napF
ybeZYX-lnt	lnt // ybeX // ybeY // ybeZ	lnt // ybeX // ybeY // ybeZ
nhaAR	nhaR // nhaA	nhaR // nhaA
fur	fur	fur
hisBHAFI	hisI // hisF // hisA // hisH // hisB	hisI // hisF // hisA // hisH // hisB
zntB	zntB	zntB
yraL	rsmI	rsmI
torI	torI	torI
ihfB	ihfB	ihfB
dinD	dinD	dinD
kdsA	kdsA	kdsA
ftsK	ftsK	ftsK
mhpR-lacI	lacI // mhpR	lacI // mhpR
ppdD-hofBC	ppdD // hofB // hofC	ppdD // hofB // hofC
agaSYBCDI	agaI // agaD // agaC // agaB // kbaY // agaS	agaI // agaD // agaC // agaB // kbaY // agaS
sapA // sapB // sapC // sapD // sapF	sapA // sapB // sapC // sapD // sapF	sapA // sapB // sapC // sapD // sapF
ynjH	ynjH	ynjH
rpnB	rpnB	rpnB
fumB	fumB	fumB
yiaY	yiaY	yiaY
fimE	fimE	fimE
hisJQMP	hisP // hisM // hisQ // hisJ	hisP // hisM // hisQ // hisJ
rcsB	rcsB	rcsB
mokC // hokC	mokC // hokC	mokC // hokC
serB-radA	radA // serB	radA // serB
ychJ	ychJ	ychJ
iraD	idlP // iraD	idlP // iraD
elaD	elaD	elaD
cynTSX	cynT // cynS // cynX	cynT // cynS // cynX
yhjG	yhjG	yhjG
rseABC	rseC // rseB // rseA	rseC // rseB // rseA
ileS-lspA-fkpB-ispH	ispH // fkpB // lspA // ileS	ispH // fkpB // lspA // ileS
sbmA-yaiW	yaiW // sbmA	yaiW // sbmA
dnaN-recF	recF // dnaN	recF // dnaN
bcp	bcp	bcp
ymgG // ymgD	ymgG // ymgD	ymgG // ymgD
yjcB	yjcB	yjcB
yejM // yejL	yejM // yejL	yejM // yejL
ubiG	ubiG	ubiG
yhhI	yhhI	yhhI
serT	serT	serT
aspU	aspU	aspU
cydAB	cydB // cydA	cydB // cydA
ptsG	ptsG	ptsG
dapB	dapB	dapB
tfaP // ycfK // ymfQ // jayE // beeE // ymfR // ymfN // ymfM // ymfL // ymfT	tfaP // ycfK // ymfQ // jayE // beeE // ymfR // ymfN // ymfM // ymfL // ymfT	tfaP // ycfK // ymfQ // jayE // beeE // ymfR // ymfN // ymfM // ymfL // ymfT
yiaT	yiaT	yiaT
yeiE	yeiE	yeiE
carAB	carA // carB	carA // carB
rpnA	rpnA	rpnA
valVW	valV // valW	valV // valW
nemA	nemA	nemA
metJ	metJ	metJ
cysG	cysG	cysG
ugpBAECQ	ugpQ // ugpC // ugpE // ugpA // ugpB	ugpQ // ugpC // ugpE // ugpA // ugpB
yceQ	yceQ	yceQ
yhbO	yhbO	yhbO
yehQ // yehP // yehM // yehL	yehQ // yehP // yehM // yehL	yehQ // yehP // yehM // yehL
mtr	mtr	mtr
yheO-tusDCB	yheO // tusD // tusC // tusB	yheO // tusD // tusC // tusB
ompC	ompC	ompC
isrC	isrC	isrC
mgrB	mgrB	mgrB
yhjJ	yhjJ	yhjJ
yggX	yggX	yggX
insE4 // insF4 // insEF4	insE4 // insF4 // insEF4	insE4 // insF4 // insEF4
ybcY	ybcY	ybcY
cyaR	cyaR	cyaR
cysB	cysB	cysB
degQS	degS // degQ	degS // degQ
fecIR	fecR // fecI	fecR // fecI
yhjR	yhjR	yhjR
hpt	hpt	hpt
infA	infA	infA
ccmABCDEFGH	ccmH // ccmG // ccmF // ccmE // ccmD // ccmC // ccmB // ccmA	ccmH // ccmG // ccmF // ccmE // ccmD // ccmC // ccmB // ccmA
yccT	yccT	yccT
yafC	yafC	yafC
yeeED	yeeE // yeeD	yeeE // yeeD
pyrD	pyrD	pyrD
yhbX	yhbX	yhbX
epd-pgk	pgk // epd	pgk // epd
macAB	macB // macA	macB // macA
metK	metK	metK
uxuR	uxuR	uxuR
ycaO	ycaO	ycaO
ybaQ	ybaQ	ybaQ
mtfA	mtfA	mtfA
narK	narK	narK
yhaH	yhaH	yhaH
rpoH	rpoH	rpoH
rne	rne	rne
tar-tap-cheRBYZ	cheZ // cheY // cheB // cheR // tap // tar	cheZ // cheY // cheB // cheR // tap // tar
hdeD	hdeD	hdeD
ybjH	ybjH	ybjH
rpmE	rpmE	rpmE
yedF // yedE	yedF // yedE	yedF // yedE
glnALG	glnG // glnL // glnA	glnG // glnL // glnA
folB	folB	folB
mngR	mngR	mngR
ymdF	ymdF	ymdF
pfkA	pfkA	pfkA
znuA	znuA	znuA
hcxB	hcxB	hcxB
pepT	pepT	pepT
yebG	yebG	yebG
bioA	bioA	bioA
ygiS	ygiS	ygiS
csgDEFG	csgG // csgF // csgE // csgD	csgG // csgF // csgE // csgD
ftsZ	ftsZ	ftsZ
actP	actP	actP
garD	garD	garD
tppB	dtpA	dtpA
rlmA	rlmA	rlmA
sohB	sohB	sohB
yghJ	yghJ	yghJ
dsdA	dsdA	dsdA
yjjP	yjjP	yjjP
lgoT	lgoT	lgoT
citCDEFXG	citG // citX // citF // citE // citD // citC	citG // citX // citF // citE // citD // citC
rplU-rpmA-yhbE-obgE	obgE // yhbE // rpmA // rplU	obgE // yhbE // rpmA // rplU
treF	treF	treF
ybeZ // ybeY	ybeZ // ybeY	ybeZ // ybeY
yeaK	yeaK	yeaK
lit	lit	lit
ydjA-selD-topB	topB // ydjA // selD	topB // ydjA // selD
yqfE	yqfE	yqfE
sgcX // sgcB // sgcC // sgcQ // sgcA // sgcE // sgcR	sgcX // sgcB // sgcC // sgcQ // sgcA // sgcE // sgcR	sgcX // sgcB // sgcC // sgcQ // sgcA // sgcE // sgcR
sibE	sibE	sibE
gltI-sroC-gltJKL	gltL // gltK // gltJ // sroC // gltI	gltL // gltK // gltJ // sroC // gltI
fliE	fliE	fliE
cspE	cspE	cspE
ydjO	ydjO	ydjO
insH-10	insH10	insH10
rplNXE-rpsNH-rplFR-rpsE-rpmD-rplO-secY-rpmJ	rpmJ // secY // rplO // rpmD // rpsE // rplR // rplF // rpsH // rpsN // rplE // rplX // rplN	rpmJ // secY // rplO // rpmD // rpsE // rplR // rplF // rpsH // rpsN // rplE // rplX // rplN
yqeC	yqeC	yqeC
lptG // lptF	lptG // lptF	lptG // lptF
yfaXWVU	yfaU // yfaV // rhmD // yfaX	yfaU // yfaV // rhmD // yfaX
araE-ygeA	ygeA // araE	ygeA // araE
tfaX	tfaX	tfaX
ydiK	ydiK	ydiK
norR	norR	norR
pntAB	pntB // pntA	pntB // pntA
ygeG	ygeG	ygeG
ytfF	ytfF	ytfF
yjdC	yjdC	yjdC
ghoST	ghoT // ghoS	ghoT // ghoS
sfmA	sfmA	sfmA
yebB	yebB	yebB
gstA	gstA	gstA
fimZ	fimZ	fimZ
ptrA-recBD	ptrA // recB // recD	ptrA // recB // recD
napFDAGHBC-ccmABCDEFGH	ccmH // ccmG // ccmF // ccmE // ccmD // ccmC // ccmB // ccmA // napC // napB // napH // napG // napA // napD // napF	ccmH // ccmG // ccmF // ccmE // ccmD // ccmC // ccmB // ccmA // napC // napB // napH // napG // napA // napD // napF
yjeJ	yjeJ	yjeJ
yfGM	yfgM	yfgM
rhoL	rhoL	rhoL
ybaN	ybaN	ybaN
ansP	ansP	ansP
ynfB-speG	speG // ynfB	speG // ynfB
crcB	crcB	crcB
queD	queD	queD
hsdMS	hsdS // hsdM	hsdS // hsdM
yjcF	yjcF	yjcF
yeiL	yeiL	yeiL
pykF	pykF	pykF
dksA-gluQ	gluQ // dksA	gluQ // dksA
tig	tig	tig
mglAC	mglC // mglA	mglC // mglA
gnsB	gnsB	gnsB
ygiZ	ygiZ	ygiZ
ygaP // ygaV	ygaP // ygaV	ygaP // ygaV
feoABC	feoC // feoA // feoB	feoC // feoA // feoB
yjbB	yjbB	yjbB
rsd	rsd	rsd
dctA	dctA	dctA
pka	patZ	patZ
insE2 // insF2 // insEF2	insE2 // insF2 // insEF2	insE2 // insF2 // insEF2
yfdX	yfdE // yfdV // oxc // frc // yfdX	yfdE // yfdV // oxc // frc // yfdX
dgcF	dgcF	dgcF
yfiE	yfiE	yfiE
abpA // abpB	abpA // abpB	abpA // abpB
creABCD	creA // creB // creC // creD	creA // creB // creC // creD
yiiR	yiiR	yiiR
xylR	xylR	xylR
yibA	yibA	yibA
appY	appY	appY
yahC	yahC	yahC
sthA	sthA	sthA
adhP	adhP	adhP
yegJ	yegJ	yegJ
yfiM	yfiM	yfiM
ampDE	ampD // ampE	ampD // ampE
yihP // yihO	yihP // yihO	yihP // yihO
rnb	rnb	rnb
mreCD	mreD // mreC	mreD // mreC
hemA	hemA	hemA
yagP	yagP	yagP
hcaR	hcaR	hcaR
ortT	ortT	ortT
ydgJ	ydgJ	ydgJ
sseB	sseB	sseB
lysU	lysU	lysU
rhtC	rhtC	rhtC
relA-mazEF	mazF // mazE // relA	mazF // mazE // relA
cadA	cadA	cadA
ydeNM	ydeM // ydeN	ydeM // ydeN
yafY // ykfB // ykfF // yafX // ykfG // ykfH // yafW // ykfI	yafY // ykfB // ykfF // yafX // ykfG // ykfH // yafW // ykfI	yafY // ykfB // ykfF // yafX // ykfG // ykfH // yafW // ykfI
tsr	tsr	tsr
cybB	cybB	cybB
ychO	ychO	ychO
ypfG	ypfG	ypfG
speAB	speB // speA	speB // speA
ravA-viaA	ravA // viaA	ravA // viaA
fabG-acpP	acpP // fabG	acpP // fabG
rdgB-yggW	hemW // rdgB	hemW // rdgB
yaiY	yaiY	yaiY
dnaQ	dnaQ	dnaQ
cstA	cstA	cstA
pinR	pinR	pinR
ycaN	ycaN	ycaN
zipA	zipA	zipA
fpr	fpr	fpr
yidK // yidJ	yidK // yidJ	yidK // yidJ
cutA	cutA	cutA
phoPQ	phoQ // phoP	phoQ // phoP
acs-yjcHG	actP // yjcH // acs	actP // yjcH // acs
yaeH	yaeH	yaeH
dnaQ	dnaQ	dnaQ
ynaJ	ynaJ	ynaJ
yqhA	yqhA	yqhA
yfdPQ	yfdQ // yfdP	yfdQ // yfdP
glnHPQ	glnQ // glnP // glnH	glnQ // glnP // glnH
gor	gor	gor
xapAB	xapB // xapA	xapB // xapA
ftsLI-murEF-mraY-murD-ftsW-murGC-ddlB-ftsQAZ-lpxC	lpxC // ftsZ // ftsA // ftsQ // ddlB // murC // murG // ftsW // murD // mraY // murF // murE // ftsI // ftsL	lpxC // ftsZ // ftsA // ftsQ // ddlB // murC // murG // ftsW // murD // mraY // murF // murE // ftsI // ftsL
ssrS	ssrS	ssrS
lpxC	lpxC	lpxC
ansB	ansB	ansB
yciW	yciW	yciW
ynfC	ynfC	ynfC
yfcF	yfcF	yfcF
narXL	narL // narX	narL // narX
avtA	avtA	avtA
ompR-envZ	envZ // ompR	envZ // ompR
eno	eno	eno
glnD	glnD	glnD
satP	satP	satP
rep	rep	rep
ychS	ychS	ychS
yjhD	yjhD	yjhD
elaB	elaB	elaB
hns	hns	hns
yhjC	yhjC	yhjC
pdhR-aceEF-lpdA	pdhR // aceE // aceF // lpd	pdhR // aceE // aceF // lpd
mreB	mreB	mreB
bamE	bamE	bamE
rrsD-ileU-alaU-rrlD-rrfD-thrV-rrfF	rrfF // thrV // rrfD // rrlD // alaU // ileU // rrsD	rrfF // thrV // rrfD // rrlD // alaU // ileU // rrsD
pgi	pgi	pgi
ymgF	ymgF	ymgF
yigE	yigE	yigE
rsuA	rsuA	rsuA
malK-lamB-malM	malK // lamB // malM	malK // lamB // malM
rhsB	rhsB	rhsB
leuX	leuX	leuX
yebA	mepM	mepM
xdhABC	xdhB // xdhC // xdhA	xdhB // xdhC // xdhA
dmsABC	dmsC // dmsB // dmsA	dmsC // dmsB // dmsA
ytfJ	ytfJ	ytfJ
ymfH // xisE // intE	ymfH // xisE // intE	ymfH // xisE // intE
yhjB	yhjB	yhjB
yeiS // sanA	yeiS // sanA	yeiS // sanA
icd	icd	icd
hslO	hslO	hslO
thrW	thrW	thrW
yceH	yceH	yceH
narU	narU	narU
bglA	bglA	bglA
glnA	glnA	glnA
grxB	grxB	grxB
tsaD	tsaD	tsaD
ilvC	ilvC	ilvC
yhdN-zntR	yhdN // zntR	yhdN // zntR
glnB	glnB	glnB
tpke11	tpke11	tpke11
treR	treR	treR
fliFGHIJK	fliK // fliJ // fliI // fliH // fliG // fliF	fliK // fliJ // fliI // fliH // fliG // fliF
yggX-mltC-nupG	nupG // mltC // yggX	nupG // mltC // yggX
wrbA-yccJ	wrbA // yccJ	wrbA // yccJ
yaiZ	yaiZ	yaiZ
sibB	sibB	sibB
ahpCF	ahpC // ahpF	ahpC // ahpF
nanR	nanR	nanR
soxR	soxR	soxR
ispDF	ispF // ispD	ispF // ispD
recN	recN	recN
qseBC	qseC // qseB	qseC // qseB
pdxA-rsmA-apaGH	apaH // apaG // rsmA // pdxA	apaH // apaG // rsmA // pdxA
ycbZ	ycbZ	ycbZ
yaaI	yaaI	yaaI
yeeA	yeeA	yeeA
purMN	purM // purN	purM // purN
yhbW	yhbW	yhbW
upp-uraA	uraA // upp	uraA // upp
CsiR	glaR	glaR
osmC	osmC	osmC
ibpB	ibpB	ibpB
ycaD	ycaD	ycaD
srmB	srmB	srmB
hiuH	hiuH	hiuH
metH	metH	metH
yqjK // yqjE // yqjD // yqjC	yqjK // yqjE // yqjD // yqjC	yqjK // yqjE // yqjD // yqjC
hscBA-fdx-iscX	iscX // fdx // hscA // hscB	iscX // fdx // hscA // hscB
rraA	rraA	rraA
flgMN	flgN // flgM	flgN // flgM
gabDTP	gabP // gabT // gabD	gabP // gabT // gabD
bssR	bssR	bssR
ybiT	ybiT	ybiT
pgsA	pgsA	pgsA
galETKM	galM // galK // galT // galE	galM // galK // galT // galE
sibD	sibD	sibD
htgA	mbiA	mbiA
yncJ	yncJ	yncJ
hemL	hemL	hemL
znuCB	znuB // znuC	znuB // znuC
ybhM	ybhM	ybhM
pdxK	pdxK	pdxK
ptrB	ptrB	ptrB
aroH	aroH	aroH
ftsP	ftsP	ftsP
osmB	osmB	osmB
qorA	qorA	qorA
nikABCDER	nikE // nikR // nikD // nikC // nikB // nikA	nikE // nikR // nikD // nikC // nikB // nikA
nagE	nagE	nagE
fbaB	fbaB	fbaB
lysZ	lysZ	lysZ
yobD	yobD	yobD
yceA	trhO	trhO
yghE // yghD	yghE // yghD	yghE // yghD
uxaB	uxaB	uxaB
pepD	pepD	pepD
yggM	yggM	yggM
ubiCA	ubiC // ubiA	ubiC // ubiA
yjiV	yjiV	yjiV
mdh	mdh	mdh
sdsN	sdsN	sdsN
mutM	mutM	mutM
rihA	rihA	rihA
mipA	mipA	mipA
ldrC	ldrC	ldrC
ruvAB	ruvB // ruvA	ruvB // ruvA
ygfB-pepP-ubiHI	ygfB // pepP // ubiH // ubiI	ygfB // pepP // ubiH // ubiI
yjhU	yjhU	yjhU
relA	relA	relA
barA	barA	barA
citT	citT	citT
yniA	yniA	yniA
insA-7	insA7	insA7
rph-pyrE	pyrE // rph	pyrE // rph
hyuA	hyuA	hyuA
tabA	tabA	tabA
nemRA	nemA // nemR	nemA // nemR
dcuA	dcuA	dcuA
ybcW	ybcW	ybcW
lolB-ispE-prs	prs // ispE // lolB	prs // ispE // lolB
ldtE	ldtE	ldtE
ompW	ompW	ompW
pcnB-folK	folK // pcnB	folK // pcnB
yqeH	yqeH	yqeH
ulaR	ulaR	ulaR
tpiA	tpiA	tpiA
ydbK-ompN	ompN // ydbK	ompN // ydbK
ppiB // lpxH	ppiB // lpxH	ppiB // lpxH
yebC-ruvC	ruvC // yebC	ruvC // yebC
add	add	add
fadE	fadE	fadE
csdE // csdA	csdE // csdA	csdE // csdA
moeAB	moeB // moeA	moeB // moeA
dtpC	dtpC	dtpC
rpe-gph-trpS	trpS // gph // rpe	trpS // gph // rpe
bepA-yfgD	yfgD // bepA	yfgD // bepA
bglG	bglG	bglG
tomB-hha	tomB // hha	tomB // hha
talA-tktB	tktB // talA	tktB // talA
ynfP	ynfP	ynfP
bisC	bisC	bisC
ygbE	ygbE	ygbE
hemCDXY	hemY // hemX // hemD // hemC	hemY // hemX // hemD // hemC
yjbQR	yjbR // yjbQ	yjbR // yjbQ
yjeFE-amiB-mutL-miaA-hfq-hflXKC	hflC // hflK // hflX // hfq // miaA // mutL // amiB // tsaE // nnr	hflC // hflK // hflX // hfq // miaA // mutL // amiB // tsaE // nnr
acnA	acnA	acnA
yhjX	yhjX	yhjX
yajR	yajR	yajR
rpsT	rpsT	rpsT
yntF-ydfK	ynfT // ydfK	ynfT // ydfK
ygiD	ygiD	ygiD
ygaQ	ygaQ	ygaQ
fabHDG	fabH // fabD // fabG	fabH // fabD // fabG
yjaG	yjaG	yjaG
cedA	cedA	cedA
lpxC	lpxC	lpxC
cbrA	cbrA	cbrA
yaiP	yaiP	yaiP
ydeO	ydeO	ydeO
lsrRK	lsrK // lsrR	lsrK // lsrR
yfgF	pdeF	pdeF
alpA	alpA	alpA
chpSB	chpS // chpB	chpS // chpB
fieF	fieF	fieF
phoPQ	phoQ // phoP	phoQ // phoP
tdcBCDEFG	tdcG // tdcF // tdcE // tdcD // tdcC // tdcB	tdcG // tdcF // tdcE // tdcD // tdcC // tdcB
yffO-yffP	yffP // yffO	yffP // yffO
ykgH	ykgH	ykgH
galU	galU	galU
yddL // yddK // yddJ	yddL // yddK // yddJ	yddL // yddK // yddJ
yegE	dgcE	dgcE
yfhL	yfhL	yfhL
acrEF	acrE // acrF	acrE // acrF
yihM // yihL	yihM // yihL	yihM // yihL
rpsA-ihfB	ihfB // rpsA	ihfB // rpsA
caiCDE	caiE // caiD // caiC	caiE // caiD // caiC
yggN	yggN	yggN
yagM // yagL	yagM // yagL	yagM // yagL
waaA	waaA	waaA
hicAB	hicB // hicA	hicB // hicA
ydeE	ydeE	ydeE
yfhM-pbpC	yfhM // pbpC	yfhM // pbpC
metF	metF	metF
yigI	yigI	yigI
feaR	feaR	feaR
rrfG	rrfG	rrfG
gadC terminator // gadC	gadC	gadC
cspI	cspI	cspI
ynbABCD	ynbD // ynbC // ynbB // ynbA	ynbD // ynbC // ynbB // ynbA
pliG	pliG	pliG
eutN // eutE // eutJ // eutG	eutN // eutE // eutJ // eutG	eutN // eutE // eutJ // eutG
phnCDEEFGHIJKLMNOP	phnP // phnO // phnN // phnM // phnL // phnK // phnJ // phnI // phnH // phnG // phnF // phnE // phnD // phnC	phnP // phnO // phnN // phnM // phnL // phnK // phnJ // phnI // phnH // phnG // phnF // phnE // phnD // phnC
bglH // yieL // yieK	bglH // yieL // yieK	bglH // yieL // yieK
hydN-hypF	hypF // hydN	hypF // hydN
hepA	rapA	rapA
mdoGH	opgH // opgG	opgH // opgG
yafDE	yafE // yafD	yafE // yafD
uvrYC	uvrC // uvrY	uvrC // uvrY
ydaY // ynaK	ydaY // ynaK	ydaY // ynaK
ybjK	rcdA	rcdA
insL3	insL3	insL3
lysA	lysA	lysA
adeQ	adeQ	adeQ
putA	putA	putA
ileS-lspA-fkpB-ispH	ispH // fkpB // lspA // ileS	ispH // fkpB // lspA // ileS
cbpAM	cbpM // cbpA	cbpM // cbpA
clcA	clcA	clcA
atpBEFHAGDC	atpC // atpD // atpG // atpA // atpH // atpF // atpE // atpB	atpC // atpD // atpG // atpA // atpH // atpF // atpE // atpB
pgrR	pgrR	pgrR
yqeK	yqeK	yqeK
yfdI // yfdH // yfdG	yfdI // yfdH // yfdG	yfdI // yfdH // yfdG
gatYZABCD	gatD // gatC // gatB // gatA // gatZ // gatY	gatD // gatC // gatB // gatA // gatZ // gatY
yibN	yibN	yibN
eda	eda	eda
dcuR	dcuR	dcuR
phoU	phoU	phoU
sgrST-setA	sgrT // setA // sgrS	sgrT // setA // sgrS
proS	proS	proS
ymiA-yciX	yciX // ymiA	yciX // ymiA
ynaI	ynaI	ynaI
yfcC	yfcC	yfcC
hycABCDEFGHI	hycI // hycH // hycG // hycF // hycE // hycD // hycC // hycB // hycA	hycI // hycH // hycG // hycF // hycE // hycD // hycC // hycB // hycA
ysaB	ysaB	ysaB
fixABCX	fixX // fixC // fixB // fixA	fixX // fixC // fixB // fixA
hypF	hypF	hypF
yeaGH	yeaH // yeaG	yeaH // yeaG
yaaA	yaaA	yaaA
lacI	lacI	lacI
ycgY	ycgY	ycgY
yjgM	yjgM	yjgM
yfaZ	yfaZ	yfaZ
flhDC	flhC // flhD	flhC // flhD
yhiD	yhiD	yhiD
proK	proK	proK
mreBCD	mreD // mreC // mreB	mreD // mreC // mreB
ygaC	ygaC	ygaC
rrsH-ileV-alaV-rrlH-rrfH	rrfH // rrlH // alaV // ileV // rrsH	rrfH // rrlH // alaV // ileV // rrsH
alaS	alaS	alaS
ariR // ymgA	ariR // ymgA	ariR // ymgA
yieG	adeP	adeP
yejF // yejE // yejB // yejA	yejF // yejE // yejB // yejA	yejF // yejE // yejB // yejA
cpdB	cpdB	cpdB
dcrB	dcrB	dcrB
argX-hisR-leuT-proM	argX // hisR // leuT // proM	argX // hisR // leuT // proM
ybcH	ybcH	ybcH
glsA-ybaT	ybaT // glsA	ybaT // glsA
fkpA	fkpA	fkpA
btuB-murI	murI // btuB	murI // btuB
roxA	roxA	roxA
yhhS	yhhS	yhhS
fumA	fumA	fumA
hofMNOP	hofM // hofN // hofO // hofP	hofM // hofN // hofO // hofP
rpoN-hpf-ptsN-yhbJ-npr	rpoN // hpf // ptsN // rapZ // npr	rpoN // hpf // ptsN // rapZ // npr
eptA	eptA	eptA
sufABCDSE	sufE // sufS // sufD // sufC // sufB // sufA	sufE // sufS // sufD // sufC // sufB // sufA
yicJI	yicI // yicJ	yicI // yicJ
menBCE	menE // menC // menB	menE // menC // menB
solA-yceO	solA // yceO	solA // yceO
ybiA	ybiA	ybiA
yehE	yehE	yehE
tyrB	tyrB	tyrB
trkA	trkA	trkA
fliAZY	tcyJ // fliZ // fliA	tcyJ // fliZ // fliA
rnlAB	rnlB // rnlA	rnlB // rnlA
mhpR-lacI	lacI // mhpR	lacI // mhpR
flhBAE	flhE // flhA // flhB	flhE // flhA // flhB
rpmBG-mutM	mutM // rpmG // rpmB	mutM // rpmG // rpmB
yccM	yccM	yccM
yaiY	yaiY	yaiY
asmA	asmA	asmA
uvrD	uvrD	uvrD
yhcE // yhcD // yhcA	yhcE // yhcD // yhcA	yhcE // yhcD // yhcA
endA	endA	endA
yhfK	yhfK	yhfK
glcDEFGBA	glcA // glcB // glcG // glcF // glcE // glcD	glcA // glcB // glcG // glcF // glcE // glcD
yfeKS	yfeS // yfeK	yfeS // yfeK
usg-truA-dedA	dedA // truA // usg	dedA // truA // usg
ycbF // ycbV // ycbU // elfG // elfC // elfD	ycbF // ycbV // ycbU // elfG // elfC // elfD	ycbF // ycbV // ycbU // elfG // elfC // elfD
uspC	uspC	uspC
yeeW // cbtA // cbeA // yeeT // yeeS // yeeR	yeeW // cbtA // cbeA // yeeT // yeeS // yeeR	yeeW // cbtA // cbeA // yeeT // yeeS // yeeR
purC	purC	purC
yraR	yraR	yraR
rpoD	rpoD	rpoD
kdsC-lptCAB	lptB // lptA // lptC // kdsC	lptB // lptA // lptC // kdsC
ribA	ribA	ribA
gntP	gntP	gntP
trxB	trxB	trxB
arcZ	arcZ	arcZ
malPQ	malQ // malP	malQ // malP
alx	alx	alx
clpPX	clpP // clpX	clpP // clpX
norR	norR	norR
flxA	flxA	flxA
crr	crr	crr
ybiY // ybiW	ybiY // ybiW	ybiY // ybiW
rhlE	rhlE	rhlE
isrB	isrB	isrB
frdABCD	frdD // frdC // frdB // frdA	frdD // frdC // frdB // frdA
ygiL	ygiL	ygiL
htpG	htpG	htpG
ftsZ	ftsZ	ftsZ
rdcAB	rdcB // rdcA	rdcB // rdcA
recAX	recX // recA	recX // recA
ybhC	ybhC	ybhC
napFDAGHBC	napC // napB // napH // napG // napA // napD // napF	napC // napB // napH // napG // napA // napD // napF
yobA // yebZ // yebY	yobA // yebZ // yebY	yobA // yebZ // yebY
argR	argR	argR
yqhG	yqhG	yqhG
bolA	bolA	bolA
serB	serB	serB
glmY	glmY	glmY
kch	kch	kch
ydgK-rsxABCDGE-nth	nth // rsxE // rsxG // rsxD // rsxC // rsxB // rsxA // ydgK	nth // rsxE // rsxG // rsxD // rsxC // rsxB // rsxA // ydgK
ybgQ // ybgP // ybgO	ybgQ // ybgP // ybgO	ybgQ // ybgP // ybgO
yoaC	yoaC	yoaC
ybfL	ybfL	ybfL
tsaB-yeaY	tsaB // yeaY	tsaB // yeaY
yjjB-dnaTC	dnaC // dnaT // yjjB	dnaC // dnaT // yjjB
gshB // rsmE	gshB // rsmE	gshB // rsmE
thrS-infC	infC // thrS	infC // thrS
rpnD	rpnD	rpnD
pepA	pepA	pepA
exuR	exuR	exuR
bssS	bssS	bssS
djlB // ybeR	djlB // ybeR	djlB // ybeR
msrB	msrB	msrB
kptA	kptA	kptA
rpsMKD-rpoA-rplQ	rplQ // rpoA // rpsD // rpsK // rpsM	rplQ // rpoA // rpsD // rpsK // rpsM
yqfA	yqfA	yqfA
insM // insI3	insM // insI3	insM // insI3
tolC-ygiBC	ygiC // ygiB // tolC	ygiC // ygiB // tolC
galETK	galK // galT // galE	galK // galT // galE
ldtB	ldtB	ldtB
dsbGp // dsbG	dsbG	dsbG
arpB	arpB	arpB
mdoC	opgC	opgC
rfbBDACX	rfbX // rfbC // rfbA // rfbD // rfbB	rfbX // rfbC // rfbA // rfbD // rfbB
ygeW	ygeW	ygeW
yjgH	yjgH	yjgH
dksA-yadB	gluQ // dksA	gluQ // dksA
bglG	bglG	bglG
ybcQ	ybcQ	ybcQ
ackA-pta	pta // ackA	pta // ackA
ydhX // ydhU // ydhT	ydhX // ydhU // ydhT	ydhX // ydhU // ydhT
hokA	hokA	hokA
otsBA	otsA // otsB	otsA // otsB
kduI	kduI	kduI
yjfKLMC	yjfC // yjfM // yjfL // yjfK	yjfC // yjfM // yjfL // yjfK
kup	kup	kup
ydcSTUV-patD	patD // ydcV // ydcU // ydcT // ydcS	patD // ydcV // ydcU // ydcT // ydcS
ybbD // ylbH // ybbC // rhsD	ybbD // ylbH // ybbC // rhsD	ybbD // ylbH // ybbC // rhsD
metE	metE	metE
tus	tus	tus
eco	eco	eco
queF	queF	queF
minCDE	minE // minD // minC	minE // minD // minC
yjdF	yjdF	yjdF
damX-dam-rpe-gph-trpS	trpS // gph // rpe // dam // damX	trpS // gph // rpe // dam // damX
cysK	cysK	cysK
gntK	gntK	gntK
pdeB	pdeB	pdeB
aspS	aspS	aspS
ydfABC	ydfC // ydfB // ydfA	ydfC // ydfB // ydfA
ampH	ampH	ampH
ygbK // ygbJ	ygbK // ygbJ	ygbK // ygbJ
glmUS	glmS // glmU	glmS // glmU
dnaB	dnaB	dnaB
acnB	acnB	acnB
clsC	clsC	clsC
esrE	esrE	esrE
yajI	yajI	yajI
ybjG	ybjG	ybjG
ydfZ	ydfZ	ydfZ
yghT	yghT	yghT
ypjB	ypjB	ypjB
yadV-htrE	htrE // yadV	htrE // yadV
birA // murB	birA // murB	birA // murB
grxA	grxA	grxA
secG-leuU	leuU // secG	leuU // secG
sdiA	sdiA	sdiA
yaiX_2 // yaiO	yaiO	yaiO
fhuF	fhuF	fhuF
yfeH	yfeH	yfeH
ratA // yfjF	ratA // yfjF	ratA // yfjF
caiTABCDE	caiE // caiD // caiC // caiB // caiA // caiT	caiE // caiD // caiC // caiB // caiA // caiT
frvA // frvB // frvX // frvR	frvA // frvB // frvX // frvR	frvA // frvB // frvX // frvR
dcuA	dcuA	dcuA
hfq-hflXKC	hflC // hflK // hflX // hfq	hflC // hflK // hflX // hfq
yjhC // yjhB	yjhC // yjhB	yjhC // yjhB
rclABC	rclC // rclB // rclA	rclC // rclB // rclA
ves	ves	ves
ydcC	ydcC	ydcC
yedD	yedD	yedD
glmY	glmY	glmY
accBC	accB // accC	accB // accC
yihF	yihF	yihF
adhE	adhE	adhE
rfaZ-waaU	waaU // waaZ	waaU // waaZ
fadD-sroD	sroD // fadD	sroD // fadD
xynR	xynR	xynR
rirA-rfaQGPSBIJYZ-waaU	rirA // waaU // waaZ // waaY // waaJ // waaO // waaB // waaS // waaP // waaG // waaQ	rirA // waaU // waaZ // waaY // waaJ // waaO // waaB // waaS // waaP // waaG // waaQ
yncK	yncK	yncK
ydcO	ydcO	ydcO
yfgJ	yfgJ	yfgJ
araBAD	araD // araA // araB	araD // araA // araB
yifL-dapF-yigA-xerC-yigB	yigB // xerC // yigA // dapF // yifL	yigB // xerC // yigA // dapF // yifL
hupB	hupB	hupB
aceK	aceK	aceK
mpaA	mpaA	mpaA
dinB-yafNOP	yafP // yafO // yafN // dinB	yafP // yafO // yafN // dinB
talA-tktB	tktB // talA	tktB // talA
ycfR	bhsA	bhsA
yffR // yffQ	yffR // yffQ	yffR // yffQ
adhE	adhE	adhE
yieH	yieH	yieH
glpR	glpR	glpR
rnlA	rnlA	rnlA
csiD-ygaF-gabDTP	gabP // gabT // gabD // lhgD // glaH	gabP // gabT // gabD // lhgD // glaH
rcsF // trmO	rcsF // trmO	rcsF // trmO
ruvAB	ruvB // ruvA	ruvB // ruvA
rzpR // ydaW // ydaV // ydaU // ydaT // ydaS	rzpR // ydaW // ydaV // ydaU // ydaT // ydaS	rzpR // ydaW // ydaV // ydaU // ydaT // ydaS
zupT	zupT	zupT
fryB // fryC // ypdF // ypdE // fryA	fryB // fryC // ypdF // ypdE // fryA	fryB // fryC // ypdF // ypdE // fryA
gltBDF	gltB // gltD // gltF	gltB // gltD // gltF
yicL	yicL	yicL
arcA	arcA	arcA
rpoD	rpoD	rpoD
ydcSTUV-patD	patD // ydcV // ydcU // ydcT // ydcS	patD // ydcV // ydcU // ydcT // ydcS
hrpB	hrpB	hrpB
ytjB-lplA	lplA // ytjB	lplA // ytjB
ycjF // ycjX	ycjF // ycjX	ycjF // ycjX
yohD	yohD	yohD
yfdF	yfdF	yfdF
entCEBA-ybdB	entC // entE // entB // entA // entH	entC // entE // entB // entA // entH
trmL	trmL	trmL
smtA-mukFEB	mukB // mukE // mukF // cmoM	mukB // mukE // mukF // cmoM
ryjB	ryjB	ryjB
glgAP	glgP // glgA	glgP // glgA
yabQ // yabP	yabQ // yabP	yabQ // yabP
pepD	pepD	pepD
yciVOQ	yciQ // yciO // yciV	yciQ // yciO // yciV
rimO	rimO	rimO
yfbS	yfbS	yfbS
exuT	exuT	exuT
yiaC // tag	yiaC // tag	yiaC // tag
putP	putP	putP
dapE-ypfN	ypfN // dapE	ypfN // dapE
asnW	asnW	asnW
yjjY	yjjY	yjjY
hemN	hemN	hemN
cvrA	cvrA	cvrA
yjgA	yjgA	yjgA
yfaV // yfaU	yfaV // yfaU	yfaV // yfaU
srlAEBD-gutM-srlR-gutQ	srlA // srlE // srlB // srlD // gutM // srlR // gutQ	srlA // srlE // srlB // srlD // gutM // srlR // gutQ
rlmJ	rlmJ	rlmJ
glyU	glyU	glyU
relBE-hokD	hokD // relE // relB	hokD // relE // relB
rrsB-gltT-rrlB-rrfB	rrfB // rrlB // gltT // rrsB	rrfB // rrlB // gltT // rrsB
rrsE-gltV-rrlE-rrfE	rrfE // rrlE // gltV // rrsE	rrfE // rrlE // gltV // rrsE
rimL	rimL	rimL
bluR	bluR	bluR
yidR	yidR	yidR
lpxT // yeiR	lpxT // yeiR	lpxT // yeiR
bioBFCD	bioB // bioF // bioC // bioD	bioB // bioF // bioC // bioD
yhhL // rsmD	yhhL // rsmD	yhhL // rsmD
argW	argW	argW
insH-7	insH7	insH7
trxA	trxA	trxA
cpxPQ	cpxQ // cpxP	cpxQ // cpxP
gcvB	gcvB	gcvB
lolE // lolD // lolC	lolE // lolD // lolC	lolE // lolD // lolC
yhhA	yhhA	yhhA
yohC	yohC	yohC
cydAB	cydA // cydB	cydA // cydB
yhfX // yhfW // php // yhfU // yhfT // yhfS	yhfX // yhfW // php // yhfU // yhfT // yhfS	yhfX // yhfW // php // yhfU // yhfT // yhfS
pyrLBI	pyrL // pyrI // pyrB	pyrL // pyrI // pyrB
yraN	yraN	yraN
exbD	exbD	exbD
lhr	lhr	lhr
gadY	gadY	gadY
yceK	yceK	yceK
ybhA	ybhA	ybhA
rcnAB	rcnB // rcnA	rcnB // rcnA
rpoH	rpoH	rpoH
yhdJ	yhdJ	yhdJ
dcuB-fumB	fumB // dcuB	fumB // dcuB
yjaH	yjaH	yjaH
metNIQ	metQ // metI // metN	metQ // metI // metN
lptB-rpoN-hpf-ptsN-yhbJ	rapZ // ptsN // hpf // rpoN // lptB	rapZ // ptsN // hpf // rpoN // lptB
argG	argG	argG
gfcA	gfcA	gfcA
yahN	yahN	yahN
tyrR	tyrR	tyrR
mlaFEDCB	mlaF // mlaE // mlaD // mlaC // mlaB	mlaF // mlaE // mlaD // mlaC // mlaB
tsx	tsx	tsx
yfaE	yfaE	yfaE
iscRSUA	iscA // iscU // iscS // iscR	iscA // iscU // iscS // iscR
ulaABCDEF	ulaF // ulaE // ulaD // ulaC // ulaB // ulaA	ulaF // ulaE // ulaD // ulaC // ulaB // ulaA
mepK-gloC	gloC // mepK	gloC // mepK
tqsA	tqsA	tqsA
insC3 // insD3 // insCD3	insC3 // insD3 // insCD3	insC3 // insD3 // insCD3
phoA-psiF	phoA // psiF	phoA // psiF
yraH	yraH	yraH
uspA	uspA	uspA
yjbEFGH	yjbH // yjbG // yjbF // yjbE	yjbH // yjbG // yjbF // yjbE
sodB	sodB	sodB
gntT	gntT	gntT
poxB // ltaE // ybjT	poxB // ltaE // ybjT	poxB // ltaE // ybjT
sraA	sraA	sraA
yedI	yedI	yedI
lacZYA	lacA // lacY // lacZ	lacA // lacY // lacZ
ygjP	ygjP	ygjP
gltA	gltA	gltA
aroH	aroH	aroH
eno	eno	eno
csrB	csrB	csrB
mntR-ybiR	ybiR // mntR	ybiR // mntR
rdlB	rdlB	rdlB
yecT	yecT	yecT
fhuACDB	fhuA // fhuC // fhuD // fhuB	fhuA // fhuC // fhuD // fhuB
tolC-ygiBC	ygiC // ygiB // tolC	ygiC // ygiB // tolC
yjaZ	yjaZ	yjaZ
ypfM	ypfM	ypfM
mgrR	mgrR	mgrR
gntR	gntR	gntR
ybhH	ybhH	ybhH
erpA	erpA	erpA
yebV	yebV	yebV
argCBH	argC // argB // argH	argC // argB // argH
yghB	yghB	yghB
pflB	pflB	pflB
yjjW	yjjW	yjjW
ykgR	ykgR	ykgR
iclR	iclR	iclR
lpp	lpp	lpp
imp	lptD	lptD
cobUST	cobT // cobS // cobU	cobT // cobS // cobU
ybfB // rhsC	ybfB // rhsC	ybfB // rhsC
dmlA	dmlA	dmlA
tyrS-pdxY	pdxY // tyrS	pdxY // tyrS
umpG-pcm	pcm // umpG	pcm // umpG
yjiK	yjiK	yjiK
yjeV	yjeV	yjeV
fabI	fabI	fabI
macB	macB	macB
dacA	dacA	dacA
ydjF	ydjF	ydjF
mcaS	mcaS	mcaS
rpsF-priB-rpsR-rplI	rpsF // priB // rpsR // rplI	rpsF // priB // rpsR // rplI
idi	idi	idi
yjhBC	yjhC // yjhB	yjhC // yjhB
cmr	mdfA	mdfA
galET	galT // galE	galT // galE
zinT	zinT	zinT
ybdM	ybdM	ybdM
ydiE	ydiE	ydiE
trmC	mnmC	mnmC
rcsB	rcsB	rcsB
ygeQ	ygeQ	ygeQ
tldE	tldE	tldE
artPIQM	artM // artQ // artI // artP	artM // artQ // artI // artP
gcvR	gcvR	gcvR
ybcK	ybcK	ybcK
hokE	hokE	hokE
ydhC	ydhC	ydhC
hdfR	hdfR	hdfR
aas // lplT	aas // lplT	aas // lplT
orn	orn	orn
ubiT-yhbS	yhbS // ubiT	yhbS // ubiT
cbpA-cbpM	cbpM // cbpA	cbpM // cbpA
qmcA-ybbJ	qmcA // ybbJ	qmcA // ybbJ
ybjP	ybjP	ybjP
mdtJI	mdtJ // mdtI	mdtJ // mdtI
dld	dld	dld
rlmD	rlmD	rlmD
lgt-thyA	thyA // lgt	thyA // lgt
yjdM	yjdM	yjdM
queA	queA	queA
sbmC	sbmC	sbmC
sucAB	sucB // sucA	sucB // sucA
mdlB // mdlA	mdlB // mdlA	mdlB // mdlA
pgk-fbaA	fbaA // pgk	fbaA // pgk
ydfV	ydfV	ydfV
ade	adeD	adeD
pncC	pncC	pncC
rlmE-ftsH	ftsH // rlmE	ftsH // rlmE
yjbJ	yjbJ	yjbJ
torR	torR	torR
ybbY-glxK	glxK // ybbY	glxK // ybbY
gapA	gapA	gapA
sbcDC	sbcD // sbcC	sbcD // sbcC
nagA	nagA	nagA
ydeI	ydeI	ydeI
ygeV	ygeV	ygeV
ypjF // yfjZ // ypjJ // yfjY // yfjX	ypjF // yfjZ // ypjJ // yfjY // yfjX	ypjF // yfjZ // ypjJ // yfjY // yfjX
dnaKJ	tpke11 // dnaK // dnaJ	tpke11 // dnaK // dnaJ
yijO	yijO	yijO
proVWX	proX // proW // proV	proX // proW // proV
hfq-hflXKC	hflC // hflK // hflX // hfq	hflC // hflK // hflX // hfq
azoR	azoR	azoR
mhpT	mhpT	mhpT
allDC-ylbA	allE // allC // allD	allE // allC // allD
ydeQ	ydeQ	ydeQ
yfbN	yfbN	yfbN
ypjD	ypjD	ypjD
baeSR	baeS // baeR	baeS // baeR
yiiF terminator // yiiF	yiiF	yiiF
yceD-rpmF	rpmF // yceD	rpmF // yceD
safA-ydeO	ydeO // safA	ydeO // safA
ubiJ // ubiB // ubiE	ubiJ // ubiB // ubiE	ubiJ // ubiB // ubiE
insF1 // insE1 // insEF1 // eaeH	insF1 // insE1 // insEF1 // eaeH	insF1 // insE1 // insEF1 // eaeH
mntH	mntH	mntH
ydcD // rhsE	ydcD // rhsE	ydcD // rhsE
yecF	yecF	yecF
yphC // yphB	yphC // yphB	yphC // yphB
gntKU	gntU // gntK	gntU // gntK
fre	fre	fre
xthA	xthA	xthA
lacYA	lacA // lacY	lacA // lacY
lpxD	lpxD	lpxD
yagA // yagB // insX	yagA // yagB // insX	yagA // yagB // insX
yzfA	yzfA	yzfA
ydcH	ydcH	ydcH
ydbK	ydbK	ydbK
hda	hda	hda
soxS	soxS	soxS
rfe-wzzE-wecBC-rffGHC-wecE-wzxE-wecF-wzyE-rffM	rffM // wzyE // wecF // wzxE // wecE // rffC // rffH // rffG // wecC // wecB // wzzE // rfe	rffM // wzyE // wecF // wzxE // wecE // rffC // rffH // rffG // wecC // wecB // wzzE // rfe
hupB	hupB	hupB
yajO	yajO	yajO
purU	purU	purU
yafL	yafL	yafL
carB	carB	carB
ydbA	ydbA	ydbA
ycdT	dgcT	dgcT
intZ	intZ	intZ
pncB	pncB	pncB
mnmE	mnmE	mnmE
paaZ	paaZ	paaZ
creABC	creC // creB // creA	creC // creB // creA
fepDGC	fepC // fepG // fepD	fepC // fepG // fepD
yaeP-rof	yaeP // rof	yaeP // rof
pnp	pnp	pnp
kilR // ydaE	kilR // ydaE	kilR // ydaE
ytfB	ytfB	ytfB
tpke70	tpke70	tpke70
leuLABCD	leuD // leuC // leuB // leuA // leuL	leuD // leuC // leuB // leuA // leuL
yicH	yicH	yicH
arcA	arcA	arcA
clpX-lon	lon // clpX	lon // clpX
lptAB	lptB // lptA	lptB // lptA
yadI	yadI	yadI
speB	speB	speB
puuCBE	puuE // puuB // puuC	puuE // puuB // puuC
yoaI	yoaI	yoaI
yfcU // yfcS // yfcR // yfcQ // yfcP // yfcO	yfcU // yfcS // yfcR // yfcQ // yfcP // yfcO	yfcU // yfcS // yfcR // yfcQ // yfcP // yfcO
fepA-entD	entD // fepA	entD // fepA
yibG	yibG	yibG
ampC	ampC	ampC
ohsC	ohsC	ohsC
pcnB-folk	folK // pcnB	folK // pcnB
yaaU	yaaU	yaaU
lysC	lysC	lysC
yciA	yciA	yciA
yjjX	yjjX	yjjX
yfbP	yfbP	yfbP
nupC	nupC	nupC
yhjV	yhjV	yhjV
putP	putP	putP
dapB	dapB	dapB
sixA	sixA	sixA
efp	efp	efp
cysE	cysE	cysE
ycgN	ycgN	ycgN
yjfP	yjfP	yjfP
atoC // atoS	atoC // atoS	atoC // atoS
uhpT	uhpT	uhpT
yhiL	yhiL	yhiL
serU	serU	serU
gspAB	gspB // gspA	gspB // gspA
infC	infC	infC
rrsB-gltT-rrlB-rrfB	rrfB // rrlB // gltT // rrsB	rrfB // rrlB // gltT // rrsB
pfkB	pfkB	pfkB
icdC	icdC	icdC
yidI	yidI	yidI
psuK // psuG	psuK // psuG	psuK // psuG
atoDAEB	atoB // atoD // atoA // atoE	atoB // atoD // atoA // atoE
yhhX	yhhX	yhhX
asnT	asnT	asnT
dfp	dfp	dfp
cpxRA	cpxA // cpxR	cpxA // cpxR
astCADBE	astE // astB // astD // astA // astC	astE // astB // astD // astA // astC
aspA-dcuA	dcuA // aspA	dcuA // aspA
ycfJ	ycfJ	ycfJ
yhdH	yhdH	yhdH
mlrA	mlrA	mlrA
appCBA-yccB	appX // appC // appB // appA	appX // appC // appB // appA
prkB	prkB	prkB
ptsHI-crr	ptsH // ptsI // crr	ptsH // ptsI // crr
uppS-cdsA	cdsA // uppS	cdsA // uppS
topA	topA	topA
rutR	rutR	rutR
mcrBC	mcrC // mcrB	mcrC // mcrB
ycdZ	ycdZ	ycdZ
ybeQ	ybeQ	ybeQ
yegX	yegX	yegX
ilvIH	ilvI // ilvH	ilvI // ilvH
tldD	tldD	tldD
ppiA	ppiA	ppiA
yfhA	glrR	glrR
ybjC-nfsA-rimK-ybjN	ybjN // rimK // nfsA // ybjC	ybjN // rimK // nfsA // ybjC
qseBC	qseC // qseB	qseC // qseB
malZ	malZ	malZ
yccA	yccA	yccA
yafV	yafV	yafV
yefM-yoeB	yefM // yoeB	yefM // yoeB
ssb	ssb	ssb
sfsB	sfsB	sfsB
clpA	clpA	clpA
glgBXCAP	glgP // glgA // glgC // glgX // glgB	glgP // glgA // glgC // glgX // glgB
cusCFBA	cusA // cusB // cusF // cusC	cusA // cusB // cusF // cusC
uidR	uidR	uidR
ycaR-kdsB	kdsB // ycaR	kdsB // ycaR
thiI	thiI	thiI
yeeO	yeeO	yeeO
ompC	ompC	ompC
tdcR	tdcR	tdcR
trmA	trmA	trmA
fliDST	fliT // fliS // fliD	fliT // fliS // fliD
cspA	cspA	cspA
gapA	gapA	gapA
rlmC // ybjO	rlmC // ybjO	rlmC // ybjO
slyA	slyA	slyA
ilvY	ilvY	ilvY
fadH	fadH	fadH
fimB	fimB	fimB
bolA	bolA	bolA
pgk-fbaA	fbaA // pgk	fbaA // pgk
lacZYA	lacA // lacY // lacZ	lacA // lacY // lacZ
mcbA	mcbA	mcbA
purT	purT	purT
yecE // yecD	yecE // yecD	yecE // yecD
deoCABD	deoC // deoA // deoB // deoD	deoC // deoA // deoB // deoD
mdaB	mdaB	mdaB
treA	treA	treA
C0719	C0719	C0719
acrD	acrD	acrD
cdaR	cdaR	cdaR
ybgS	ybgS	ybgS
cysS	cysS	cysS
msrC	msrC	msrC
aceBAK	aceB // aceA // aceK	aceB // aceA // aceK
gss	gss	gss
pflB	pflB	pflB
ytjA	ytjA	ytjA
yfiRN	dgcN // yfiR	dgcN // yfiR
ycgZ-ymgA-ariR-ymgC	ymgC // ariR // ymgA // ycgZ	ymgC // ariR // ymgA // ycgZ
rpoE-rseABC	rseD // rseC // rseB // rseA // rpoE	rseD // rseC // rseB // rseA // rpoE
bcsABZC	bcsC // bcsZ // bcsB // bcsA	bcsC // bcsZ // bcsB // bcsA
ybfF	ybfF	ybfF
yeaR-yoaG	yeaR // yoaG	yeaR // yoaG
trpS	trpS	trpS
speF-potE	speFL // potE // speF	speFL // potE // speF
cmtB // cmtA // yggP // yggF // fumE // yggC	cmtB // cmtA // yggP // yggF // fumE // yggC	cmtB // cmtA // yggP // yggF // fumE // yggC
hypT	hypT	hypT
uvrB	uvrB	uvrB
panD	panD	panD
hypBCDE-fhlA	fhlA // hypE // hypD // hypC // hypB	fhlA // hypE // hypD // hypC // hypB
ybeF	ybeF	ybeF
ynjI	ynjI	ynjI
insH-9	insH9	insH9
rpoE-rseABC	rseC // rseB // rseA // rpoE	rseC // rseB // rseA // rpoE
ghxQ // guaD // xanQ	ghxQ // guaD // xanQ	ghxQ // guaD // xanQ
yjgW	yjgW	yjgW
rph	rph	rph
grcA	grcA	grcA
nfeF	nfeF	nfeF
ybdK	ybdK	ybdK
aroD // ydiB // ydiN	aroD // ydiB // ydiN	aroD // ydiB // ydiN
mug	mug	mug
prfB-lysS	lysS // prfB	lysS // prfB
ygeL // ygeK	ygeL // ygeK	ygeL // ygeK
ytfL	ytfL	ytfL
ydhYVWXUT	ydhT // ydhU // ydhX // ydhW // ydhV // ydhY	ydhT // ydhU // ydhX // ydhW // ydhV // ydhY
feaB	feaB	feaB
peaD	peaD	peaD
dinQ	dinQ	dinQ
ydhF	ydhF	ydhF
grxD	grxD	grxD
ygdQ	ygdQ	ygdQ
nlpD-rpoS	rpoS // nlpD	rpoS // nlpD
yjeM	yjeM	yjeM
rpoS	rpoS	rpoS
leuE	leuE	leuE
ybaL	ybaL	ybaL
artJ	artJ	artJ
ynfL	ynfL	ynfL
dacC	dacC	dacC
ygcU	ygcU	ygcU
ribF-ileS-lspA-fkpB-ispH	ribF // ileS // lspA // fkpB // ispH	ribF // ileS // lspA // fkpB // ispH
yjcS	yjcS	yjcS
phoH	phoH	phoH
aspS	aspS	aspS
ssrA	ssrA	ssrA
ybaE	ybaE	ybaE
acrD	acrD	acrD
rem	rem	rem
omrB	omrB	omrB
gshA	gshA	gshA
fliDST	fliD // fliS // fliT	fliD // fliS // fliT
xylE	xylE	xylE
mlc-ynfK	ynfK // mlc	ynfK // mlc
iraP	iraP	iraP
leuLABCD	leuD // leuC // leuB // leuA // leuL	leuD // leuC // leuB // leuA // leuL
yaiI	yaiI	yaiI
slyB	slyB	slyB
yneK	yneK	yneK
alaE	alaE	alaE
yfjU	yfjU	yfjU
dcm-vsr	vsr // dcm	vsr // dcm
yijF	yijF	yijF
nikR	nikR	nikR
mutL-miaA-hfq-hflXKC	hflC // hflK // hflX // hfq // miaA // mutL	hflC // hflK // hflX // hfq // miaA // mutL
csrA	csrA	csrA
yahK	yahK	yahK
allA	allA	allA
yddA // yddB	yddA // yddB	yddA // yddB
yfaL	yfaL	yfaL
yfiL	yfiL	yfiL
ascFB	ascF // ascB	ascF // ascB
yihV-csqR	csqR // yihV	csqR // yihV
glnK-amtB	amtB // glnK	amtB // glnK
deoA	deoD // deoB // deoA	deoD // deoB // deoA
bamD	bamD	bamD
ecpA	ecpA	ecpA
yrdD-rimN-aroE-yrdB	yrdB // aroE // tsaC // yrdD	yrdB // aroE // tsaC // yrdD
mcbR	mcbR	mcbR
yeaM	nimR	nimR
yfhR	yfhR	yfhR
kbl-tdh	tdh // kbl	tdh // kbl
tatABC	tatD // tatC // tatB // tatA	tatD // tatC // tatB // tatA
ilvLXG_1G_2MEDA	ilvX // ilvG // ilvA // ilvD // ilvE // ilvM // ilvL	ilvX // ilvG // ilvA // ilvD // ilvE // ilvM // ilvL
dhaM	dhaM	dhaM
rfaDFCL	waaL // waaC // waaF // rfaD	waaL // waaC // waaF // rfaD
ykfC	ykfC	ykfC
srlR	srlR	srlR
sokB	sokB	sokB
ydaL	smrA	smrA
yffB-dapE-ypfN	ypfN // dapE // yffB	ypfN // dapE // yffB
rhaT	rhaT	rhaT
yifN	yifN	yifN
rnc-era-recO-pdxJ-acpS	acpS // pdxJ // recO // era // rnc	acpS // pdxJ // recO // era // rnc
yacG	yacG	yacG
yceI	yceI	yceI
yafJ	yafJ	yafJ
ilvIH	ilvH // ilvI	ilvH // ilvI
hslJ	hslJ	hslJ
yccR	sxy	sxy
yfeW // murP // murQ	yfeW // murP // murQ	yfeW // murP // murQ
glyA	glyA	glyA
yidA	yidA	yidA
phr	phr	phr
yciSM-pyrF-yciH	yciH // pyrF // lapB // lapA	yciH // pyrF // lapB // lapA
proP	proP	proP
dxr-uppS-cdsA	cdsA // uppS // dxr	cdsA // uppS // dxr
ilvA	ilvA	ilvA
ttcA	ttcA	ttcA
yrdA	yrdA	yrdA
yfdE	yfdE	yfdE
dps	dps	dps
yicG	yicG	yicG
metY-yhbC-nusA-infB-rbfA-truB-rpsO-pnp	pnp // rpsO // truB // rbfA // infB // nusA // rimP // metY	pnp // rpsO // truB // rbfA // infB // nusA // rimP // metY
hcp-hcr	hcr // hcp	hcr // hcp
yrbG-kdsDC-lptCAB	lptB // lptA // lptC // kdsC // kdsD // yrbG	lptB // lptA // lptC // kdsC // kdsD // yrbG
nadC	nadC	nadC
ppiD	ppiD	ppiD
ymjA	ymjA	ymjA
yoaE	yoaE	yoaE
folC-dedD terminator // folC // dedD	folC // dedD	folC // dedD
aspA	aspA	aspA
yibF	yibF	yibF
tolB-pal-ybgF	cpoB // pal // tolB	cpoB // pal // tolB
hchA	hchA	hchA
cbrBC	cbrC // cbrB	cbrC // cbrB
sokC	sokC	sokC
ung	ung	ung
insZ	insZ	insZ
yjiR	yjiR	yjiR
yfbL	yfbL	yfbL
cynR	cynR	cynR
pdeK	pdeK	pdeK
pykF	pykF	pykF
ileS-lspA-fkpB-ispH	ispH // fkpB // lspA // ileS	ispH // fkpB // lspA // ileS
sdsR-pphA	sdsR // pphA	sdsR // pphA
dnaN-recF	recF // dnaN	recF // dnaN
blc	blc	blc
ycgI	ycgI	ycgI
yjcC	pdeC	pdeC
mqo	mqo	mqo
ebgAC	ebgA // ebgC	ebgA // ebgC
yhiI // rbbA // yhhJ	yhiI // rbbA // yhhJ	yhiI // rbbA // yhhJ
serX	serX	serX
gspCDEFGHIJKLMO	gspO // gspM // gspL // gspK // gspJ // gspI // gspH // gspG // gspF // gspE // gspD // gspC	gspO // gspM // gspL // gspK // gspJ // gspI // gspH // gspG // gspF // gspE // gspD // gspC
fldB	fldB	fldB
grcA	grcA	grcA
lysP	lysP	lysP
stfE // tfaE	stfE // tfaE	stfE // tfaE
yiaU	yiaU	yiaU
yeiH	yeiH	yeiH
argD	argD	argD
yzgL	yzgL	yzgL
proL	proL	proL
ogrK	ogrK	ogrK
metJ	metJ	metJ
rpmF-plsX-fabHDG	fabG // fabD // fabH // plsX // rpmF	fabG // fabD // fabH // plsX // rpmF
ugpBAECQ	ugpQ // ugpC // ugpE // ugpA // ugpB	ugpQ // ugpC // ugpE // ugpA // ugpB
rluC	rluC	rluC
yhbP	yhbP	yhbP
yehR	yehR	yehR
purA	purA	purA
slyD	slyD	slyD
yhfA	yhfA	yhfA
ispG-sroE	ispG // sroE	ispG // sroE
topA	topA	topA
yieEF	yieF // yieE	yieF // yieE
yggX-mltC	mltC // yggX	mltC // yggX
ycdU // ymdE	ycdU // ymdE	ycdU // ymdE
ybdH	hcxA	hcxA
insF5 // insE5 // insEF5	insF5 // insE5 // insEF5	insF5 // insE5 // insEF5
cysJIH	cysH // cysI // cysJ	cysH // cysI // cysJ
yhcN	yhcN	yhcN
appA	appA	appA
wbbIJK	wbbK // wbbJ // wbbI	wbbK // wbbJ // wbbI
gcd	gcd	gcd
bamD	bamD	bamD
fadIJ	fadJ // fadI	fadJ // fadI
hspQ	hspQ	hspQ
yafF	yafF	yafF
plaP	plaP	plaP
recA	recA	recA
folP-glmM	folP // glmM	folP // glmM
cvpA-purF-ubiX	ubiX // purF // cvpA	ubiX // purF // cvpA
nhaR	nhaR	nhaR
pspF	pspF	pspF
metA	metA	metA
ycaP	ycaP	ycaP
sseA	sseA	sseA
yeeJ	yeeJ	yeeJ
nirBDC-cysG	nirB // nirD // nirC // cysG	nirB // nirD // nirC // cysG
yhaI	yhaI	yhaI
rpoH	rpoH	rpoH
smg	smg	smg
ycgR	ycgR	ycgR
gapA-yeaD	yeaD // gapA	yeaD // gapA
ybjJ // ybjI	ybjJ // ybjI	ybjJ // ybjI
ryeA	ryeA	ryeA
yedK	yedK	yedK
glpABC	glpA // glpB // glpC	glpA // glpB // glpC
ebgR	ebgR	ebgR
fimB	fimB	fimB
ybdR	ybdR	ybdR
pgk	pgk	pgk
idnK	idnK	idnK
ybiJ	ybiJ	ybiJ
pitA	pitA	pitA
yebK	yebK	yebK
cirA	cirA	cirA
mqsRA	mqsR // mqsA	mqsR // mqsA
stpA	stpA	stpA
bax	bax	bax
rhaD	rhaD	rhaD
gudPXD	gudD // gudX // gudP	gudD // gudX // gudP
lysQ terminator (TERM0-1234) // lysQ terminator (TERM0-1233) // lysQ	lysQ	lysQ
rpsO	rpsO	rpsO
yobF-cspC	yobF // cspC	yobF // cspC
mpl	mpl	mpl
yghQ	yghQ	yghQ
focA-pflB	pflB // focA	pflB // focA
rsmC	rsmC	rsmC
lgoR	lgoR	lgoR
dpiBA	dpiA // dpiB	dpiA // dpiB
sdsN	sdsN	sdsN
pcnB-folK	folK // pcnB	folK // pcnB
miaB	miaB	miaB
nimT	nimT	nimT
luxS	luxS	luxS
serC-aroA	serC // aroA	serC // aroA
ygfI	ygfI	ygfI
yjhP	yjhP	yjhP
sibC	sibC	sibC
metG	metG	metG
rtcR	rtcR	rtcR
ybeM	ybeM	ybeM
nadE	nadE	nadE
insH-11	insH11	insH11
rplU-rpmA	rpmA // rplU	rpmA // rplU
mocA	mocA	mocA
yjgR	yjgR	yjgR
pstS	pstS	pstS
ralA	ralA	ralA
ybdG	ybdG	ybdG
rprA	rprA	rprA
nlpA	nlpA	nlpA
potABCD	potD // potC // potB // potA	potD // potC // potB // potA
ygeH	ygeH	ygeH
qorB	qorB	qorB
groL	groL	groL
feaR	feaR	feaR
sfmD // sfmC	sfmD // sfmC	sfmD // sfmC
yebB	yebB	yebB
mliC	mliC	mliC
fsaA	fsaA	fsaA
ppdAB-ygdB-ppdC-recC	ppdA // ppdB // ygdB // ppdC // recC	ppdA // ppdB // ygdB // ppdC // recC
narZYWV	narV // narW // narY // narZ	narV // narW // narY // narZ
epmB	epmB	epmB
rpoS	rpoS	rpoS
tatABC	tatC // tatB // tatA	tatC // tatB // tatA
apt	apt	apt
ansP	ansP	ansP
ynfD	ynfD	ynfD
cspF	cspF	cspF
ygcP // ygcO // ygcN	ygcP // ygcO // ygcN	ygcP // ygcO // ygcN
hslVU	hslU // hslV	hslU // hslV
gltP	gltP	gltP
rihB	rihB	rihB
pykF	pykF	pykF
yibD	waaH	waaH
ybaV	ybaV	ybaV
dhaR	dhaR	dhaR
ynfN	ynfN	ynfN
aaeR	aaeR	aaeR
ygaM	ygaM	ygaM
fes-ybdZ-entF-fepE	ybdZ // fes // entF // fepE	ybdZ // fes // entF // fepE
yjbD	yjbD	yjbD
rsd	rsd	rsd
yafZ	yafZ	yafZ
shiA	shiA	shiA
yrbL	yrbL	yrbL
glsB // yneG	glsB // yneG	glsB // yneG
yfiF	yfiF	yfiF
yfjM	yfjM	yfjM
cydDC	cydC // cydD	cydC // cydD
priA	priA	priA
hmp	hmp	hmp
casDE-ygbTF	cas2 // cas1 // casE // casD	cas2 // cas1 // casE // casD
gpmM-envC-yibQ	yibQ // envC // gpmM	yibQ // envC // gpmM
yahG // yahF // yahE // yahD	yahG // yahF // yahE // yahD	yahG // yahF // yahE // yahD
evgAS	evgS // evgA	evgS // evgA
maeA	maeA	maeA
yeiG	yeiG	yeiG
kgtP	kgtP	kgtP
ansA-pncA	pncA // ansA	pncA // ansA
yihQ	yihQ	yihQ
rnb	rnb	rnb
rrlA-rrfA	rrfA // rrlA	rrfA // rrlA
bamA	bamA	bamA
paoA // paoB // paoC // paoD	paoA // paoB // paoC // paoD	paoA // paoB // paoC // paoD
hcaEFCBD	hcaD // hcaB // hcaC // hcaF // hcaE	hcaD // hcaB // hcaC // hcaF // hcaE
ydcY	ydcY	ydcY
ydhQ	ydhQ	ydhQ
pepB	pepB	pepB
oppABCDF	oppA // oppB // oppC // oppD // oppF	oppA // oppB // oppC // oppD // oppF
yigL // pldB	yigL // pldB	yigL // pldB
mazEFG	mazG // mazF // mazE	mazG // mazF // mazE
csgC	csgC	csgC
ydeI	ydeI	ydeI
ykfA // yafZ	ykfA // yafZ	ykfA // yafZ
gcd	gcd	gcd
ydcA	ydcA	ydcA
yciN	yciN	yciN
nudK	nudK	nudK
guaBA	guaA // guaB	guaA // guaB
kup	kup	kup
dadAX	dadX // dadA	dadX // dadA
dcd	dcd	dcd
tolA // tolR // tolQ // ybgC	tolA // tolR // tolQ // ybgC	tolA // tolR // tolQ // ybgC
yafT	yafT	yafT
cstA	cstA	cstA
ynaE	ynaE	ynaE
ycbC	elyC	elyC
cysZ	cysZ	cysZ
nfo	nfo	nfo
glvC // glvB // glvG // ysdC	glvC // glvB // glvG // ysdC	glvC // glvB // glvG // ysdC
cmk-rpsA	rpsA // cmk	rpsA // cmk
ygbF	cas2	cas2
metBL	metL // metB	metL // metB
yaeI	yaeI	yaeI
dnaQ	dnaQ	dnaQ
uspE	uspE	uspE
yqhC	yqhC	yqhC
yfdT // yfdS // yfdR	yfdT // yfdS // yfdR	yfdT // yfdS // yfdR
glpFKX	glpX // glpK // glpF	glpX // glpK // glpF
htrL	htrL	htrL
tauABCD	tauD // tauC // tauB // tauA	tauD // tauC // tauB // tauA
ftsLI-murEF-mraY-murD-ftsW-murGC-ddlB-ftsQAZ-lpxC	lpxC // ftsZ // ftsA // ftsQ // ddlB // murC // murG // ftsW // murD // mraY // murF // murE // ftsI // ftsL	lpxC // ftsZ // ftsA // ftsQ // ddlB // murC // murG // ftsW // murD // mraY // murF // murE // ftsI // ftsL
iraM	iraM	iraM
uof-fur	uof // fur	uof // fur
kbaZ-agaVWA	agaA // agaW // agaV // kbaZ	agaA // agaW // agaV // kbaZ
fabI	fabI	fabI
yniB	yniB	yniB
yfcG	yfcG	yfcG
fdnGHI	fdnG // fdnH // fdnI	fdnG // fdnH // fdnI
ysaA	ysaA	ysaA
lldPRD	lldD // lldR // lldP	lldD // lldR // lldP
eno	eno	eno
glrR-glnB	glnB // glrR	glnB // glrR
yaaW	yaaW	yaaW
rplKAJL-rpoBC	rpoC // rpoB // rplL // rplJ // rplA // rplK	rpoC // rpoB // rplL // rplJ // rplA // rplK
rttR	rttR	rttR
yjhR	yjhR	yjhR
elaA	elaA	elaA
gyrA	gyrA	gyrA
yhjD	yhjD	yhjD
lpdA	lpd	lpd
rydC	rydC	rydC
psd-mscM	mscM // psd	mscM // psd
dnaN-recF	recF // dnaN	recF // dnaN
adk	adk	adk
ycgH	ycgH	ycgH
yihA	yihA	yihA
radD	radD	radD
speC	speC	speC
yhhH	yhhH	yhhH
metT-leuW-glnUW-metU-glnVX	glnX // glnV // metU // glnW // glnU // leuW // metT	glnX // glnV // metU // glnW // glnU // leuW // metT
aspT	aspT	aspT
cydAB	cydB // cydA	cydB // cydA
moaABCDE	moaE // moaD // moaC // moaB // moaA	moaE // moaD // moaC // moaB // moaA
ybhK	ybhK	ybhK
ymfJ	ymfJ	ymfJ
yiaF	yiaF	yiaF
preTA	preA // preT	preA // preT
mdh	mdh	mdh
greB	greB	greB
argU	argU	argU
mviM	yceM	yceM
flu	isrC // flu	isrC // flu
ytfE	ytfE	ytfE
cytR	cytR	cytR
mdtH	mdtH	mdtH
ygjH	ygjH	ygjH
yehH // yehI	yehH // yehI	yehH // yehI
malT	malT	malT
gspCDEFGHIJKLMO	gspO // gspM // gspL // gspK // gspJ // gspI // gspH // gspG // gspF // gspE // gspD // gspC	gspO // gspM // gspL // gspK // gspJ // gspI // gspH // gspG // gspF // gspE // gspD // gspC
cvpA-purF-ubiX	ubiX // purF // cvpA	ubiX // purF // cvpA
rseX	rseX	rseX
treR	treR	treR
gltIJKL-sroC	sroC // gltL // gltK // gltJ // gltI	sroC // gltL // gltK // gltJ // gltI
mutY-yggX	yggX // mutY	yggX // mutY
efeU	efeU	efeU
yajQ	yajQ	yajQ
yegP	yegP	yegP
ansB	ansB	ansB
zapE	zapE	zapE
livKHMGF	livF // livG // livM // livH // livK	livF // livG // livM // livH // livK
truD	truD	truD
rlmL-uup	rlmL // uup	rlmL // uup
recC	recC	recC
apaGH	apaH // apaG	apaH // apaG
yccFS	yccF // yccS	yccF // yccS
yacH	yacH	yacH
sbmC	sbmC	sbmC
purR	purR	purR
deaD	deaD	deaD
nlpD-rpoS	rpoS // nlpD	rpoS // nlpD
ybbB	selU	selU
pth-ychF	ychF // pth	ychF // pth
groSL	groL // groS	groL // groS
ycaM	ycaM	ycaM
chiX	chiX	chiX
msrQ // msrP	msrQ // msrP	msrQ // msrP
nagBACD	umpH // nagC // nagA // nagB	umpH // nagC // nagA // nagB
yqjF	yqjF	yqjF
hypBCDE	hypB // hypC // hypD // hypE	hypB // hypC // hypD // hypE
relA-mazEF	mazF // mazE // relA	mazF // mazE // relA
flgK	flgL // flgK	flgL // flgK
gntRKU	gntU // gntK // gntR	gntU // gntK // gntR
yliI	yliI	yliI
ribC	ribC	ribC
sdiA	sdiA	sdiA
glnALG	glnG // glnL // glnA	glnG // glnL // glnA
hldE	hldE	hldE
htgA	mbiA	mbiA
insQ	insQ	insQ
hemL	hemL	hemL
zntA	zntA	zntA
ybhP // clsB // ybhN	ybhP // clsB // ybhN	ybhP // clsB // ybhN
pepE	pepE	pepE
yebE	yebE	yebE
aroL-yaiA-aroM	aroL // yaiA // aroM	aroL // yaiA // aroM
plsC	plsC	plsC
csgBAC	csgC // csgB // csgA	csgC // csgB // csgA
coaA	coaA	coaA
htpG	htpG	htpG
norVW	norW // norV	norW // norV
pgaABCD	pgaD // pgaC // pgaB // pgaA	pgaD // pgaC // pgaB // pgaA
cbl	cbl	cbl
mraZW-ftsLI-murEF-mraY-murD-ftsW-murGC-ddlB-ftsQAZ-lpxC	lpxC // ftsZ // ftsA // ftsQ // ddlB // murC // murG // ftsW // murD // mraY // murF // murE // ftsI // ftsL // rsmH // mraZ	lpxC // ftsZ // ftsA // ftsQ // ddlB // murC // murG // ftsW // murD // mraY // murF // murE // ftsI // ftsL // rsmH // mraZ
yghG	yghG	yghG
xseB-ispA-dxs-yajO	yajO // dxs // ispA // xseB	yajO // dxs // ispA // xseB
yehF	yehF	yehF
trmB // yggL	trmB // yggL	trmB // yggL
udk-dcd	dcd // udk	dcd // udk
yjiXA	yjiX // yjiA	yjiX // yjiA
uxaCA	uxaA // uxaC	uxaA // uxaC
sdiA	sdiA	sdiA
ybbN	cnoX	cnoX
insH3	insH3	insH3
cdgI	cdgI	cdgI
ldrD	ldrD	ldrD
secE-nusG	secE // nusG	secE // nusG
zapA	zapA	zapA
yjhF	yjhF	yjhF
murQP	murP // murQ	murP // murQ
micL	micL	micL
ygcG	ygcG	ygcG
citCDEFXG	citC // citD // citE // citF // citX // citG	citC // citD // citE // citF // citX // citG
hxpB	hxpB	hxpB
insG	insG	insG
rplJL-rpoBC	rplJ // rplL // rpoB // rpoC	rplJ // rplL // rpoB // rpoC
yqeA	yqeA	yqeA
yjgL	yjgL	yjgL
yliM-ompX	yliM // ompX	yliM // ompX
aroL-yaiA-aroM	aroM // yaiA // aroL	aroM // yaiA // aroL
nohD	nohD	nohD
narK	narK	narK
rydB	rydB	rydB
nudG	nudG	nudG
pflDC	pflD // pflC	pflD // pflC
yqeJ // yqeI	yqeJ // yqeI	yqeJ // yqeI
fklB	fklB	fklB
menA-rraA	rraA // menA	rraA // menA
nanA	nanA	nanA
ybcI	ybcI	ybcI
ruvC	ruvC	ruvC
blr	blr	blr
fadR	fadR	fadR
tcdA	tcdA	tcdA
motAB-cheAW	cheW // cheA // motB // motA	cheW // cheA // motB // motA
dsbD // yjdC	dsbD // yjdC	dsbD // yjdC
yfgM	yfgM	yfgM
ilvL	ilvL	ilvL
mscK	mscK	mscK
yiaG	yiaG	yiaG
rspA-rspB	rspA // rspB	rspA // rspB
can	can	can
casABCDE12	casA // casB // casC // casD // casE // cas1 // cas2	casA // casB // casC // casD // casE // cas1 // cas2
hipBA	hipA // hipB	hipA // hipB
ghxP	ghxP	ghxP
adiY	adiY	adiY
trg	trg	trg
cspI	cspI	cspI
ampG	ampG	ampG
lsrACDBFG-tam	tam // lsrG // lsrF // lsrB // lsrD // lsrC // lsrA	tam // lsrG // lsrF // lsrB // lsrD // lsrC // lsrA
pinQ	pinQ	pinQ
ygiH	plsY	plsY
kbp	kbp	kbp
fabZ	fabZ	fabZ
yjaA	yjaA	yjaA
zraP	zraP	zraP
acnB	acnB	acnB
recG	recG	recG
hemB	hemB	hemB
yegRZ	yegZ // yegR	yegZ // yegR
tam	tam	tam
yfgO	yfgO	yfgO
yfjI	yfjI	yfjI
clpPX	clpP // clpX	clpP // clpX
sbp terminator // sbp	sbp	sbp
polA	polA	polA
phnLMNOP	phnP // phnO // phnN // phnM // phnL	phnP // phnO // phnN // phnM // phnL
araFGH	araH // araG // araF	araH // araG // araF
yahA	pdeL	pdeL
amyA	amyA	amyA
yddG	yddG	yddG
yegH	yegH	yegH
patZ // tapT	patZ // tapT	patZ // tapT
adiA	adiA	adiA
yihN	yihN	yihN
rpsA-ihfB	ihfB // rpsA	ihfB // rpsA
rrlE-rrfE	rrfE // rrlE	rrfE // rrlE
htrG	ygiM	ygiM
yagN	yagN	yagN
istR-2	istR	istR
ydcR	ydcR	ydcR
ydeJ	ydeJ	ydeJ
IS128	IS128	IS128
rhaBAD	rhaD // rhaA // rhaB	rhaD // rhaA // rhaB
pldA	pldA	pldA
cfa	cfa	cfa
cysH	cysH	cysH
gadC terminator // gadC	gadC	gadC
frsA	frsA	frsA
cspB	cspB	cspB
hrpA	hrpA	hrpA
ychH	ychH	ychH
eutS // eutP // eutQ // eutT // eutD // eutM	eutS // eutP // eutQ // eutT // eutD // eutM	eutS // eutP // eutQ // eutT // eutD // eutM
pstSCAB-phoU	phoU // pstB // pstA // pstC // pstS	phoU // pstB // pstA // pstC // pstS
mnmG-rsmG	mnmG // rsmG	mnmG // rsmG
acpP-fabF	fabF // acpP	fabF // acpP
xerD-dsbC-recJ	recJ // dsbC // xerD	recJ // dsbC // xerD
hlpA-lpxD-fabZ-lpxA	lpxA // fabZ // lpxD // skp	lpxA // fabZ // lpxD // skp
mltD	mltD	mltD
valS	valS	valS
lomR // ynaA	lomR // ynaA	lomR // ynaA
ybjM	ybjM	ybjM
pdeA	pdeA	pdeA
lysR	lysR	lysR
emrD	emrD	emrD
nmpC	nmpC	nmpC
ribE-nusB-thiL-pgpA	pgpA // thiL // nusB // ribE	pgpA // thiL // nusB // ribE
rutABCDEFG	rutA // rutB // rutC // rutD // rutE // rutF // rutG	rutA // rutB // rutC // rutD // rutE // rutF // rutG
mnt-btuF-yadS	mtn // btuF // yadS	mtn // btuF // yadS
atpBEFHAGDC	atpC // atpD // atpG // atpA // atpH // atpF // atpE // atpB	atpC // atpD // atpG // atpA // atpH // atpF // atpE // atpB
mppA	mppA	mppA
yqgC	yqgC	yqgC
tfaS	tfaS	tfaS
gcvTHP	gcvP // gcvH // gcvT	gcvP // gcvH // gcvT
gpmM-envC-yibQ	yibQ // envC // gpmM	yibQ // envC // gpmM
rpoE-rseABC	rseD // rseC // rseB // rseA // rpoE	rseD // rseC // rseB // rseA // rpoE
gadXW	gadW // gadX	gadW // gadX
uxaB	uxaB	uxaB
leuO	leuO	leuO
ssb	ssb	ssb
pgpB	pgpB	pgpB
yncD	yncD	yncD
yfcD	yfcD	yfcD
hypABCDE	hypA // hypB // hypC // hypD // hypE	hypA // hypB // hypC // hypD // hypE
yiaA	yiaA	yiaA
ompR-envZ	envZ // ompR	envZ // ompR
yahA	pdeL	pdeL
yhdWXYZ	yhdZ // yhdY // yhdX // yhdW	yhdZ // yhdY // yhdX // yhdW
yaaJ	yaaJ	yaaJ
lpp	lpp	lpp
ycgV	ycgV	ycgV
yjgN	yjgN	yjgN
arnF // arnE // arnT // arnD // arnA // arnC // arnB	arnF // arnE // arnT // arnD // arnA // arnC // arnB	arnF // arnE // arnT // arnD // arnA // arnC // arnB
malS	malS	malS
mdtEF	mdtF // mdtE	mdtF // mdtE
pheU	pheU	pheU
mreB	mreB	mreB
lpxP	lpxP	lpxP
rrsH-ileV-alaV-rrlH-rrfH	rrfH // rrlH // alaV // ileV // rrsH	rrfH // rrlH // alaV // ileV // rrsH
pepD	pepD	pepD
ymgC	ymgC	ymgC
yifB	yifB	yifB
yejG	yejG	yejG
fur	fur	fur
yhhT	yhhT	yhhT
thrU-tyrU-glyT-thrT-tufB	tufB // thrU // tyrU // glyT // thrT	tufB // thrU // tyrU // glyT // thrT
ybgTE	ybgE // cydX	ybgE // cydX
cueO	cueO	cueO
fkpA	fkpA	fkpA
dinG-ybiB	ybiB // dinG	ybiB // dinG
rluE // nudJ	rluE // nudJ	rluE // nudJ
yhiM	yhiM	yhiM
dusC	dusC	dusC
fumC	fumC	fumC
igaA	igaA	igaA
glmUS	glmS // glmU	glmS // glmU
galF	galF	galF
micF	micF	micF
ahpF	ahpF	ahpF
ubiE-yigP-ubiB	ubiB // ubiJ // ubiE	ubiB // ubiJ // ubiE
dinI	dinI	dinI
ybiN	rlmF	rlmF
mrp	mrp	mrp
tyrP	tyrP	tyrP
mscL	mscL	mscL
rpsU	rpsU	rpsU
secG	secG	secG
mgtA	mgtL // mgtA	mgtL // mgtA
rne	rne	rne
mutY-yggX-mltC-nupG	nupG // mltC // yggX // mutY	nupG // mltC // yggX // mutY
torS	torS	torS
ybaY	ybaY	ybaY
yegL // pphC	yegL // pphC	yegL // pphC
ada-alkB	alkB // ada	alkB // ada
yhcF // yhcE_2	yhcF	yhcF
sdaCB	sdaC // sdaB	sdaC // sdaB
frwD	frwD	frwD
glcC	glcC	glcC
bepA-yfgD	yfgD // bepA	yfgD // bepA
flk	flk	flk
zapC	zapC	zapC
uspG	uspG	uspG
yoeF	yoeF	yoeF
purHD	purD // purH	purD // purH
ubiT-yhbS	ubiT // yhbS	ubiT // yhbS
rpoD	rpoD	rpoD
lptAB	lptB // lptA	lptB // lptA
ribA	ribA	ribA
gntXY	nfuA // yhgH	nfuA // yhgH
lolA-rarA	rarA // lolA	rarA // lolA
glmZ	glmZ	glmZ
hchA	hchA	hchA
melR	melR	melR
sstT	sstT	sstT
glgS	glgS	glgS
asnC-mioC	mioC // asnC	mioC // asnC
fliC	fliC	fliC
bglGFB	bglB // bglF // bglG	bglB // bglF // bglG
iaaA-gsiABCD	gsiD // gsiC // gsiB // gsiA // iaaA	gsiD // gsiC // gsiB // gsiA // iaaA
rhtB	rhtB	rhtB
ftnA	ftnA	ftnA
galS	galS	galS
insC5CD5D5-yqiHIG	yqiI // yqiH // yqiG // insD5 // insC5 // insCD5	yqiI // yqiH // yqiG // insD5 // insC5 // insCD5
yadV-htrE	htrE // yadV	htrE // yadV
C0465	C0465	C0465
ykfBF-yafX-ykfGH-yafW-ykfI	ykfI // yafW // ykfH // ykfG // yafX // ykfF // ykfB	ykfI // yafW // ykfH // ykfG // yafX // ykfF // ykfB
galETKM	galM // galK // galT // galE	galM // galK // galT // galE
ybhB	ybhB	ybhB
oxyS	oxyS	oxyS
holE	holE	holE
aroF-tyrA	tyrA // aroF	tyrA // aroF
yqhH	yqhH	yqhH
cbpAM	cbpM // cbpA	cbpM // cbpA
nadR // radA	nadR // radA	nadR // radA
yahE	yahE	yahE
puuP	ymjE // puuP	ymjE // puuP
rsxABCDGE-nth	nth // rsxE // rsxG // rsxD // rsxC // rsxB // rsxA	nth // rsxE // rsxG // rsxD // rsxC // rsxB // rsxA
ybgD	ybgD	ybgD
nudL // pabB	nudL // pabB	nudL // pabB
ybfD	ybfD	ybfD
yoaA	yoaA	yoaA
adrA	dgcC	dgcC
yqgF // yqgE	yqgF // yqgE	yqgF // yqgE
ybgC-tolQRA	ybgC // tolQ // tolR // tolA	ybgC // tolQ // tolR // tolA
yjiS	yjiS	yjiS
gadE-mdtEF	gadF // mdtF // mdtE // gadE	gadF // mdtF // mdtE // gadE
lgt	lgt	lgt
ldhA	ldhA	ldhA
djlC // ybeU	djlC // ybeU	djlC // ybeU
yeaD	yeaD	yeaD
ldrA	ldrA	ldrA
rpsP-rimM-trmD-rplS	rplS // trmD // rimM // rpsP	rplS // trmD // rimM // rpsP
yqfB	yqfB	yqfB
yjhV // yjhW // insO2	yjhV	yjhV
galK	galK	galK
mltF	mltF	mltF
rnk	rnk	rnk
yniD	yniD	yniD
marC	marC	marC
rnc-era	era // rnc	era // rnc
ygeX	ygeX	ygeX
bdcA	bdcA	bdcA
ecnB	ecnB	ecnB
yejG	yejG	yejG
rzoD	rzoD	rzoD
pta	pta	pta
ydhY // ydhV // ydhW	ydhY // ydhV // ydhW	ydhY // ydhV // ydhW
iap	iap	iap
panBC	panC // panB	panC // panB
yqeF	yqeF	yqeF
yjfN	yjfN	yjfN
kup	kup	kup
acpP	acpP	acpP
ylbG	ylbG	ylbG
metR	metR	metR
ydgA	ydgA	ydgA
emtA	emtA	emtA
ppnN	ppnN	ppnN
moaABCDE	moaA // moaB // moaC // moaD // moaE	moaA // moaB // moaC // moaD // moaE
yjdJ // yjdI	yjdJ // yjdI	yjdJ // yjdI
dam-rpe-gph-trpS	trpS // gph // rpe // dam	trpS // gph // rpe // dam
ucpA	ucpA	ucpA
ivbL	ivbL	ivbL
ylaC	ylaC	ylaC
pgl	pgl	pgl
dicF	dicF	dicF
aslA	aslA	aslA
ygbM // ygbL	ygbM // ygbL	ygbM // ygbL
glyQS	glyS // glyQ	glyS // glyQ
alr	alr	alr
spf	spf	spf
bssS	bssS	bssS
thrL	thrL	thrL
nrdR-ribDE-nusB-thiL-pgpA	pgpA // thiL // nusB // ribE // ribD // nrdR	pgpA // thiL // nusB // ribE // ribD // nrdR
ompT	ompT	ompT
ydfI	ydfI	ydfI
yghU	yghU	yghU
ypjC	ypjC	ypjC
envY-ompT	ompT // envY	ompT // envY
sroH	sroH	sroH
mutS	mutS	mutS
secG-leuU	leuU // secG	leuU // secG
sdiA	sdiA	sdiA
insD1 // insC1 // insCD1	insD1 // insC1 // insCD1	insD1 // insC1 // insCD1
otsBA	otsB // otsA	otsB // otsA
yneO	yneO	yneO
yfeN	yfeN	yfeN
smpB	smpB	smpB
chbBCARFG	chbG // chbF // chbR // chbA // chbC // chbB	chbG // chbF // chbR // chbA // chbC // chbB
kdgT	kdgT	kdgT
aroP	aroP	aroP
tyrV-tpr	tpr // tyrV	tpr // tyrV
yghF	yghF	yghF
rclR	rclR	rclR
agp	agp	agp
pptA	pptA	pptA
yedP	yedP	yedP
pgpC-tadA	pgpC // tadA	pgpC // tadA
accD	accD	accD
yihI	yihI	yihI
pqiABC	pqiC // pqiB // pqiA	pqiC // pqiB // pqiA
selD-topB	topB // selD	topB // selD
yggN	yggN	yggN
insA3 // insB3 // insAB3	insA3 // insB3 // insAB3	insA3 // insB3 // insAB3
rfaQGPSBIJYZ-waaU	waaU // waaZ // waaY // waaJ // waaO // waaB // waaS // waaP // waaG // waaQ	waaU // waaZ // waaY // waaJ // waaO // waaB // waaS // waaP // waaG // waaQ
sutR	sutR	sutR
yddH	yddH	yddH
rlmN	rlmN	rlmN
fadBA	fadA // fadB	fadA // fadB
yigG // yigF	yigG // yigF	yigG // yigF
xseA	xseA	xseA
glxK	glxK	glxK
ydbK-ompN	ompN // ydbK	ompN // ydbK
yafNOP	yafP // yafO // yafN	yafP // yafO // yafN
rhoL-rho	rhoL // rho	rhoL // rho
pdxI	pdxI	pdxI
ycgB	ycgB	ycgB
yffS	yffS	yffS
nrfABCDEFG	nrfA // nrfB // nrfC // nrfD // nrfE // nrfF // nrfG	nrfA // nrfB // nrfC // nrfD // nrfE // nrfF // nrfG
cbrB	cbrB	cbrB
glpR	glpR	glpR
rrsA-ileT-alaT-rrlA-rrfA	rrfA // rrlA // alaT // ileT // rrsA	rrfA // rrlA // alaT // ileT // rrsA
pdeR	pdeR	pdeR
gmhB	gmhB	gmhB
ptrA	ptrA	ptrA
rzoR	rzoR	rzoR
zur	zur	zur
yfeO	yfeO	yfeO
livJ	livJ	livJ
nepI	nepI	nepI
arcA	arcA	arcA
nagC	nagC	nagC
plsB	plsB	plsB
fldA-uof-fur	uof // fur // fldA	uof // fur // fldA
tyrP	tyrP	tyrP
ymjC // mpaA	ymjC // mpaA	ymjC // mpaA
ypdI	ypdI	ypdI
yfdC	yfdC	yfdC
tonB	tonB	tonB
secB-gpsA	secB // gpsA	secB // gpsA
mobAB	mobB // mobA	mobB // mobA
sroA	sroA	sroA
pstCAB-phoU	phoU // pstB // pstA // pstC	phoU // pstB // pstA // pstC
yabI	yabI	yabI
pyrG-eno	eno // pyrG	eno // pyrG
rluB	rluB	rluB
gstB	gstB	gstB
yfbU-hxpA	yfbU // hxpA	yfbU // hxpA
fecABCDE	fecE // fecD // fecC // fecB // fecA	fecE // fecD // fecC // fecB // fecA
yiaD	yiaD	yiaD
putP	putP	putP
hypF	hypF	hypF
argT-hisJQMP	hisP // hisM // hisQ // hisJ // argT	hisP // hisM // hisQ // hisJ // argT
yjtD	yjtD	yjtD
hisS	hisS	hisS
ldcA	ldcA	ldcA
yjgB	ahr	ahr
yfaX // rhmD	yfaX // rhmD	yfaX // rhmD
udp	udp	udp
gor	gor	gor
metY-yhbC-nusA-infB	infB // nusA // rimP // metY	infB // nusA // rimP // metY
insJ	insJ	insJ
gpmA	gpmA	gpmA
rrsG-gltW-rrlG-rrfG	rrfG // rrlG // gltW // rrsG	rrfG // rrlG // gltW // rrsG
manA	manA	manA
bluF	bluF	bluF
cbrA	cbrA	cbrA
mepS	mepS	mepS
cadC	cadC	cadC
yhhN	yhhN	yhhN
pheV	pheV	pheV
insH-2	insH2	insH2
trxC	trxC	trxC
srkA-dsbA	dsbA // srkA	dsbA // srkA
metY-yhbC-nusA-infB-rbfA-truB-rpsO-pnp	pnp // rpsO // truB // rbfA // infB // nusA // rimP // metY	pnp // rpsO // truB // rbfA // infB // nusA // rimP // metY
cobB // nagK	cobB // nagK	cobB // nagK
panZ	panZ	panZ
yohF	yohF	yohF
cyoABCDE	cyoE // cyoD // cyoC // cyoB // cyoA	cyoE // cyoD // cyoC // cyoB // cyoA
yhfZ // yhfY	yhfZ // yhfY	yhfZ // yhfY
pyrLBI	pyrL // pyrI // pyrB	pyrL // pyrI // pyrB
diaA	diaA	diaA
fhuE	fhuE	fhuE
rnlB	rnlB	rnlB
mutY-yggX	yggX // mutY	yggX // mutY
mdtG	mdtG	mdtG
ybhD	ybhD	ybhD
rcnB	rcnB	rcnB
tnaCAB	tnaC // tnaA // tnaB	tnaC // tnaA // tnaB
yhdU	yhdU	yhdU
glgCAP	glgP // glgA // glgC	glgP // glgA // glgC
ymbA	pqiC	pqiC
serA	serA	serA
yecR	yecR	yecR
yicR-rpmBG-mutM	mutM // rpmG // rpmB // yicR	mutM // rpmG // rpmB // yicR
insB4 // insA4 // insAB4	insB4 // insA4 // insAB4	insB4 // insA4 // insAB4
yahO	yahO	yahO
wcaK // wcaL // wcaM	wcaK // wcaL // wcaM	wcaK // wcaL // wcaM
uvrA	uvrA	uvrA
elbB // mtgA	elbB // mtgA	elbB // mtgA
yecM-cutC	yecM // cutC	yecM // cutC
rlmM	rlmM	rlmM
dcuD	dcuD	dcuD
spy	spy	spy
ulaG	ulaG	ulaG
asnS	asnS	asnS
ubiF	ubiF	ubiF
phoBR	phoB // phoR	phoB // phoR
yraK // yraJ // yraI	yraK // yraJ // yraI	yraK // yraJ // yraI
rpsU-dnaG-rpoD	rpsU // dnaG // rpoD	rpsU // dnaG // rpoD
mtr	mtr	mtr
asr	asr	asr
asnB	asnB	asnB
lysO	lysO	lysO
micA	micA	micA
yedR // yedJ	yedR // yedJ	yedR // yedJ
lexA-dinF	lexA // dinF	lexA // dinF
ygjQ	ygjQ	ygjQ
dnaKJ	tpke11 // dnaK // dnaJ	tpke11 // dnaK // dnaJ
rpmI-rplT	rplT // rpmI	rplT // rpmI
eno	eno	eno
crr	crr	crr
ybiU	ybiU	ybiU
rdlC	rdlC	rdlC
insA5B5AB5	insA5 // insB5 // insAB5	insA5 // insB5 // insAB5
dusB-fis	dusB // fis	dusB // fis
sroG-ribB	sroG // ribB	sroG // ribB
htpX	htpX	htpX
yeiW	yeiW	yeiW
selD-topB	topB // selD	topB // selD
gntR	gntR	gntR
ybhI	ybhI	ybhI
nfuA	nfuA	nfuA
yebW	yebW	yebW
argF	argF	argF
yqhD-dkgA	dkgA // yqhD	dkgA // yqhD
pflB	pflB	pflB
yjjI	yjjI	yjjI
yobF-cspC	cspC // yobF	cspC // yobF
secMA-mutT	mutT // secA // secM	mutT // secA // secM
ybgIJKL-nei	nei // pxpA // pxpC // pxpB // ybgI	nei // pxpA // pxpC // pxpB // ybgI
imp	lptD	lptD
bamA-hlpA-lpxD-fabZ-lpxAB-rnhB-dnaE	dnaE // rnhB // lpxB // lpxA // fabZ // lpxD // skp // bamA	dnaE // rnhB // lpxB // lpxA // fabZ // lpxD // skp // bamA
ybfC // ybfO	ybfC // ybfO	ybfC // ybfO
yeaW // yeaV	yeaW // yeaV	yeaW // yeaV
yjjB-dnaTC-yjjA	yjjA // dnaC // dnaT // yjjB	yjjA // dnaC // dnaT // yjjB
tehAB	tehA // tehB	tehA // tehB
yjiM // yjiL	yjiM // yjiL	yjiM // yjiL
ogt	ogt	ogt
yajG-ampG	ampG // yajG	ampG // yajG
macB	macB	macB
rsfS-rlmH-mrdAB-rlpA	rsfS // rlmH // mrdA // mrdB // rlpA	rsfS // rlmH // mrdA // mrdB // rlpA
ydjLKJIHG	ydjL // ydjK // ydjJ // ydjI // ydjH // ydjG	ydjL // ydjK // ydjJ // ydjI // ydjH // ydjG
ivy	ivy	ivy
rpsJ-rplCDWB-rpsS-rplV-rpsC-rplP-rpmC-rpsQ	rpsQ // rpmC // rplP // rpsC // rplV // rpsS // rplB // rplW // rplD // rplC // rpsJ	rpsQ // rpmC // rplP // rpsC // rplV // rpsS // rplB // rplW // rplD // rplC // rpsJ
xerD	xerD	xerD
yjhE	yjhE	yjhE
tolC-ygiBC	ygiC // ygiB // tolC	ygiC // ygiB // tolC
galET	galT // galE	galT // galE
ydhB	ydhB	ydhB
ybdN	ybdN	ybdN
ydiV	ydiV	ydiV
micC	micC	micC
rcsC	rcsC	rcsC
glyU	glyU	glyU
cybC	cybC	cybC
ybgA-phr	phr // ybgA	phr // ybgA
degQ	degQ	degQ
ybcM // ybcL	ybcM // ybcL	ybcM // ybcL
cho	cho	cho
ydhR	ydhR	ydhR
helD	helD	helD
nuoABCEFGHIJKLMN	nuoN // nuoM // nuoL // nuoK // nuoJ // nuoI // nuoH // nuoG // nuoF // nuoE // nuoC // nuoB // nuoA	nuoN // nuoM // nuoL // nuoK // nuoJ // nuoI // nuoH // nuoG // nuoF // nuoE // nuoC // nuoB // nuoA
ygeA	ygeA	ygeA
yjeT	yjeT	yjeT
rpsMKD-rpoA-rplQ	rpsK // rpsD // rpoA // rplQ // rpsM	rpsK // rpsD // rpoA // rplQ // rpsM
cbpA-cbpM	cbpM // cbpA	cbpM // cbpA
fetAB	fetB // fetA	fetB // fetA
yggE	yggE	yggE
ydgH	ydgH	ydgH
dsrA	dsrA	dsrA
yqcC // truC // yqcA	yqcC // truC // yqcA	yqcC // truC // yqcA
mdoGH	opgG // opgH	opgG // opgH
rdcAB	rdcB // rdcA	rdcB // rdcA
aroKB-damX-dam-rpe-gph-trpS	trpS // gph // rpe // dam // damX // aroB // aroK	trpS // gph // rpe // dam // damX // aroB // aroK
gatZABCD	gatA // gatB // gatC // gatD // gatZ	gatA // gatB // gatC // gatD // gatZ
trpL	trpL	trpL
ffs	ffs	ffs
epd-pgk-fbaA	fbaA // pgk // epd	fbaA // pgk // epd
dicC-ydfXW	dicC // ydfX // ydfW	dicC // ydfX // ydfW
ais	ais	ais
mltB	mltB	mltB
ftsYEX	ftsX // ftsE // ftsY	ftsX // ftsE // ftsY
yjbM // yjbL	yjbM // yjbL	yjbM // yjbL
acnA	acnA	acnA
entH	entH	entH
fumC	fumC	fumC
brnQ-proY	proY // brnQ	proY // brnQ
hemL	hemL	hemL
ydfG	ydfG	ydfG
ygfZ	ygfZ	ygfZ
ypjA	ypjA	ypjA
dnaTC-yjjA	yjjA // dnaC // dnaT	yjjA // dnaC // dnaT
eptC	eptC	eptC
proVWX	proX // proW // proV	proX // proW // proV
hfq-hflXKC	hflC // hflK // hflX // hfq	hflC // hflK // hflX // hfq
ddpXABCDF	ddpF // ddpD // ddpC // ddpB // ddpA // ddpX	ddpF // ddpD // ddpC // ddpB // ddpA // ddpX
yaiL	yaiL	yaiL
yhhY	yhhY	yhhY
ydeT // ydeS // ydeR	ydeT // ydeS // ydeR	ydeT // ydeS // ydeR
yfcN	smrB	smrB
yfjD	yfjD	yfjD
basRS	basS // basR	basS // basR
fdhD	fdhD	fdhD
yceD-rpmF	rpmF // yceD	rpmF // yceD
yaiA-aroM	aroM // yaiA	aroM // yaiA
yjhC // yjhB	yjhC // yjhB	yjhC // yjhB
ykgA	ykgA	ykgA
rpiA	rpiA	rpiA
yncI	yncI	yncI
yecH	yecH	yecH
yphF // yphE // yphD	yphF // yphE // yphD	yphF // yphE // yphD
gntT	gntT	gntT
pepQ-yigZ-trkH-hemG	hemG // trkH // yigZ // pepQ	hemG // trkH // yigZ // pepQ
rnpB	rnpB	rnpB
rfbACX	rfbX // rfbC // rfbA	rfbX // rfbC // rfbA
ydiY	ydiY	ydiY
yagF // yagE	yagF // yagE	yagF // yagE
galP	galP	galP
ydcL	ydcL	ydcL
ydcI	ydcI	ydcI
yfgG	yfgG	yfgG
torCAD	torC // torA // torD	torC // torA // torD
yifK	yifK	yifK
hupB	hupB	hupB
nrdG	nrdG	nrdG
purU	purU	purU
rayT	rayT	rayT
yhfG-fic-pabA	pabA // fic // yhfG	pabA // fic // yhfG
insC2 // insD2 // insCD2	insC2 // insD2 // insCD2	insC2 // insD2 // insCD2
yceF	yceF	yceF
yffL	yffL	yffL
manXYZ	manX // manY // manZ	manX // manY // manZ
mdtL	mdtL	mdtL
glpEGR	glpR // glpG // glpE	glpR // glpG // glpE
nfuA	nfuA	nfuA
csiE	csiE	csiE
yaeQ-arfB-nlpE	nlpE // arfB // yaeQ	nlpE // arfB // yaeQ
rplT	rplT	rplT
ydaG // ydaF	ydaG // ydaF	ydaG // ydaF
ytfH	ytfH	ytfH
alaC	alaC	alaC
umuDC	umuD // umuC	umuD // umuC
selC	selC	selC
arcA	arcA	arcA
chaC	chaC	chaC
yjbEFGH	yjbH // yjbG // yjbF // yjbE	yjbH // yjbG // yjbF // yjbE
yadE	yadE	yadE
pheMST-ihfA	ihfA // pheM // pheT // pheS	ihfA // pheM // pheT // pheS
ompG // ymjB // ycjV // ycjU // ycjT // ycjS // ycjR // ycjQ // ycjP // ycjO // ycjN // ycjM	ompG // ymjB // ycjV // ycjU // ycjT // ycjS // ycjR // ycjQ // ycjP // ycjO // ycjN // ycjM	ompG // ymjB // ycjV // ycjU // ycjT // ycjS // ycjR // ycjQ // ycjP // ycjO // ycjN // ycjM
yobH	yobH	yobH
yfcV	yfcV	yfcV
fepB	fepB	fepB
yibI // yibH	yibI // yibH	yibI // yibH
eda	eda	eda
shoB	shoB	shoB
alaA-yfbR	yfbR // alaA	yfbR // alaA
kefC // kefF	kefC // kefF	kefC // kefF
lysC	lysC	lysC
yciCB	yciC // yciB	yciC // yciB
yjjZ	yjjZ	yjjZ
alaA	alaA	alaA
dsdXA	dsdX // dsdA	dsdX // dsdA
eptB	eptB	eptB
putP	putP	putP
cyaA	cyaA	cyaA
yfeYX	yfeX // yfeY	yfeX // yfeY
sugE	gdx	gdx
gcvR	gcvR	gcvR
dsbB	dsbB	dsbB
yjfY	yjfY	yjfY
yfaA // yfaT // yfaS // yfaQ // yfaP	yfaA // yfaT // yfaS // yfaQ // yfaP	yfaA // yfaT // yfaS // yfaQ // yfaP
melAB	melA // melB	melA // melB
dtpB	dtpB	dtpB
alaWX	alaX // alaW	alaX // alaW
gspAB	gspB // gspA	gspB // gspA
infC-rpmI-rplT	rplT // rpmI // infC	rplT // rpmI // infC
rrsC-gltU-rrlC-rrfC	rrfC // rrlC // gltU // rrsC	rrfC // rrlC // gltU // rrsC
gltX	gltX	gltX
iraM	iraM	iraM
yidL	yidL	yidL
yeiP	yeiP	yeiP
betIBA	betA // betB // betI	betA // betB // betI
insB6 // insA6 // insAB6 // yrhA // yhhZ	insB6 // insA6 // insAB6 // yrhA // yhhZ	insB6 // insA6 // insAB6 // yrhA // yhhZ
asnU	asnU	asnU
clpS	clpS	clpS
emrKY	emrY // emrK	emrY // emrK
pyrH	pyrH	pyrH
entS	entS	entS
ldtC	ldtC	ldtC
yhgE	yhgE	yhgE
yohO	yohO	yohO
araFGH	araH // araG // araF	araH // araG // araF
tsgA	tsgA	tsgA
ptsHI-crr	ptsH // ptsI // crr	ptsH // ptsI // crr
cdsA	cdsA	cdsA
topA	topA	topA
narWV	narV // narW	narV // narW
gadEF-mdtEF	gadF // mdtF // mdtE // gadE	gadF // mdtF // mdtE // gadE
ymdA	ymdA	ymdA
ybeT	ybeT	ybeT
thiMD	thiM // thiD	thiM // thiD
purEK	purK // purE	purK // purE
yhdP	yhdP	yhdP
ppiA	ppiA	ppiA
holC	holC	holC
rimK-ybjN	ybjN // rimK	ybjN // rimK
yraP	yraP	yraP
aes	aes	aes
gfcE // etp // etk	gfcE // etp // etk	gfcE // etp // etk
yagJ	yagJ	yagJ
wzzB	wzzB	wzzB
sulA	sulA	sulA
murA	murA	murA
nuoABCEFGHIJKLMN	nuoN // nuoM // nuoL // nuoK // nuoJ // nuoI // nuoH // nuoG // nuoF // nuoE // nuoC // nuoB // nuoA	nuoN // nuoM // nuoL // nuoK // nuoJ // nuoI // nuoH // nuoG // nuoF // nuoE // nuoC // nuoB // nuoA
yeiL	yeiL	yeiL
cusRS	cusS // cusR	cusS // cusR
gnd	gnd	gnd
ycbJ	ycbJ	ycbJ
torT	torT	torT
ldtA	ldtA	ldtA
ompF	ompF	ompF
yhaC // yhaB	yhaC // yhaB	yhaC // yhaB
uspA	uspA	uspA
ftnB	ftnB	ftnB
nanATEK-yhcH	yhcH // nanK // nanE // nanT // nanA	yhcH // nanK // nanE // nanT // nanA
idnR	idnR	idnR
ybjQ-amiD	amiD // ybjQ	amiD // ybjQ
slyX	slyX	slyX
dgcQ	dgcQ	dgcQ
katG	katG	katG
higBA	higB // higA	higB // higA
rlmE-ftsH	ftsH // rlmE	ftsH // rlmE
tig	tig	tig
gpmA	gpmA	gpmA
lacZYA	lacA // lacY // lacZ	lacA // lacY // lacZ
ybiO	ybiO	ybiO
rdgC	rdgC	rdgC
cmoB // cmoA // yecN	cmoB // cmoA // yecN	cmoB // cmoA // yecN
deoCABD	deoC // deoA // deoB // deoD	deoC // deoA // deoB // deoD
ygiN	ygiN	ygiN
treR	treR	treR
yggG	loiP	loiP
greA	greA	greA
alsRBACE	alsE // alsC // alsA // alsB // alsR	alsE // alsC // alsA // alsB // alsR
modE // modF	modE // modF	modE // modF
dosCP	dosP // dosC	dosP // dosC
yebT // yebS	yebT // yebS	yebT // yebS
alkA	alkA	alkA
yghW	yghW	yghW
pflB	pflB	pflB
yjjV // yjjU	yjjV // yjjU	yjjV // yjjU
iraD	idlP // ytiD // ytiC // iraD	idlP // ytiD // ytiC // iraD
rpoE-rseABC	rseC // rseB // rseA // rpoE	rseC // rseB // rseA // rpoE
bcsQ	bcsQ	bcsQ
ybfP	ybfP	ybfP
dmlR	dmlR	dmlR
aslB	aslB	aslB
sspAB	sspB // sspA	sspB // sspA
tktA	tktA	tktA
yjiH // yjiG // iadA	yjiH // yjiG // iadA	yjiH // yjiG // iadA
gadE	gadF // gadE	gadF // gadE
accA	accA	accA
frlABCDR	frlR // frlD // frlC // frlB // frlA	frlR // frlD // frlC // frlB // frlA
lipB	lipB	lipB
sppA terminator // sppA	sppA	sppA
intD	intD	intD
rpoZ-spoT-trmH-recG	rpoZ // spoT // trmH // recG	rpoZ // spoT // trmH // recG
ygfT // ygfS	ygfT // ygfS	ygfT // ygfS
mdtEF	mdtF // mdtE	mdtF // mdtE
galE	galE	galE
yegS	yegS	yegS
insL2	insL2	insL2
ydiO // ydiF	ydiO // ydiF	ydiO // ydiF
mrr	mrr	mrr
proBA	proB // proA	proB // proA
insC4 // insD4 // insCD4 // ygeO // ygeN	insC4 // insD4 // insCD4 // ygeO // ygeN	insC4 // insD4 // insCD4 // ygeO // ygeN
ytfP // tamB // tamA	ytfP // tamB // tamA	ytfP // tamB // tamA
artPIQM	artM // artQ // artI // artP	artM // artQ // artI // artP
tynA	tynA	tynA
insF3 // insE3 // insEF3	insF3 // insE3 // insEF3	insF3 // insE3 // insEF3
symE	symE	symE
ydhL	ydhL	ydhL
gsk	gsk	gsk
ygdR	ygdR	ygdR
yjeO // yjeN	yjeO // yjeN	yjeO // yjeN
eno	eno	eno
agrA	agrA	agrA
fsr	fsr	fsr
pfkB	pfkB	pfkB
ynfM	ynfM	ynfM
dcp	dcp	dcp
ygcW	ygcW	ygcW
kdpDE	kdpE // kdpD	kdpE // kdpD
yjdP	yjdP	yjdP
yajC-secDF	secF // secD // yajC	secF // secD // yajC
flu	flu	flu
yfeCD	yfeD // yfeC	yfeD // yfeC
cof	cof	cof
gatR_2	gatR	gatR
hokD	hokD	hokD
omrA	omrA	omrA
yqaB // yqaA	yqaB // yqaA	yqaB // yqaA
fliFGHIJK	fliF // fliG // fliH // fliI // fliJ // fliK	fliF // fliG // fliH // fliI // fliJ // fliK
yjbI	yjbI	yjbI
xapR	xapR	xapR
tig	tig	tig
rsmG	rsmG	rsmG
ppnP	ppnP	ppnP
slyB	slyB	slyB
mgtS	mgtS	mgtS
ygbI	ygbI	ygbI
yfjV	yfjV	yfjV
def-fmt	def // fmt	def // fmt
ptsA // fsaB // gldA	ptsA // fsaB // gldA	ptsA // fsaB // gldA
hyfABCDEFGHIJR-focB	focB // hyfR // hyfJ // hyfI // hyfH // hyfG // hyfF // hyfE // hyfD // hyfC // hyfB // hyfA	focB // hyfR // hyfJ // hyfI // hyfH // hyfG // hyfF // hyfE // hyfD // hyfC // hyfB // hyfA
miaA-hfq-hflXKC	hflC // hflK // hflX // hfq // miaA	hflC // hflK // hflX // hfq // miaA
csrA	csrA	csrA
yahL	yahL	yahL
allS	allS	allS
ydeM	ydeM	ydeM
nudI	nudI	nudI
yfiR-dgcN-yfiB	yfiB // dgcN // yfiR	yfiB // dgcN // yfiR
ascG	ascG	ascG
yihXY-dtd-fabY	fabY // dtd // yihY // yihX	fabY // dtd // yihY // yihX
yiaKLMNO-lyx-sgbHUE	yiaM // sgbE // sgbU // sgbH // lyxK // yiaO // yiaN // yiaL // yiaK	yiaM // sgbE // sgbU // sgbH // lyxK // yiaO // yiaN // yiaL // yiaK
menD-yfbB-menBCE	menE // menC // menB // menH // menD	menE // menC // menB // menH // menD
rseP	rseP	rseP
ecpR	ecpR	ecpR
smf	smf	smf
yncG	yncG	yncG
yeaP	dgcP	dgcP
hcaT	hcaT	hcaT
argE	argE	argE
tatD	tatD	tatD
ilvEDA	ilvA // ilvD // ilvE	ilvA // ilvD // ilvE
tufA	tufA	tufA
rfaDFCL	waaL // waaC // waaF // rfaD	waaL // waaC // waaF // rfaD
mmuM // mmuP	mmuM // mmuP	mmuM // mmuP
uvrD	uvrD	uvrD
ydcJ	ydcJ	ydcJ
ydaM	dgcM	dgcM
ypfH	ypfH	ypfH
zwf	zwf	zwf
gpp	gpp	gpp
pdxJ-acpS	acpS // pdxJ	acpS // pdxJ
pdxY	pdxY	pdxY
bhsA	bhsA	bhsA
ldtF	ldtF	ldtF
ilvIH	ilvH // ilvI	ilvH // ilvI
ydbL // ynbE // ydbH	ydbL // ynbE // ydbH	ydbL // ynbE // ydbH
yccU	yccU	yccU
ypeA // yfeZ	ypeA // yfeZ	ypeA // yfeZ
mtlADR	mtlA // mtlD // mtlR	mtlA // mtlD // mtlR
yihG	yihG	yihG
yiaJ	plaR	plaR
ycjXF-tyrR	tyrR // ycjF // ycjX	tyrR // ycjF // ycjX
sra	sra	sra
yaeR	yaeR	yaeR
umpH	umpH	umpH
recE // recT // ralR // rcbA // xisR // intR	recE // recT // ralR // rcbA // xisR // intR	recE // recT // ralR // rcbA // xisR // intR
ysgA	ysgA	ysgA
yfdV	yfdV	yfdV
ompR-envZ	envZ // ompR	envZ // ompR
gmk	gmk	gmk
metY	metY	metY
wzbc	wza // wzc // wzb	wza // wzc // wzb
kdsC-lptCAB	lptB // lptA // lptC // kdsC	lptB // lptA // lptC // kdsC
yacL	yacL	yacL
ppiD	ppiD	ppiD
puuAP	ymjE // puuP // puuA	ymjE // puuP // puuA
yoaF	yoaF	yoaF
yfcJ	yfcJ	yfcJ
fruBKA	fruA // fruK // fruB	fruA // fruK // fruB
yibA // rhsA	yibA // rhsA	yibA // rhsA
rpoH	rpoH	rpoH
emrE	emrE	emrE
yciG	yciG	yciG
insA1 // insB1 // insAB1	insA1 // insB1 // insAB1	insA1 // insB1 // insAB1
gltX	gltX	gltX
ychE	ychE	ychE
yjjK	ettA	ettA
yfbM	yfbM	yfbM
cysPUWAM	cysM // cysA // cysW // cysU // cysP	cysM // cysA // cysW // cysU // cysP
bcsEFG	bcsG // bcsF // bcsE	bcsG // bcsF // bcsE
uxuAB	uxuB // uxuA	uxuB // uxuA
crp	crp	crp
yeaY	yeaY	yeaY
uspB	uspB	uspB
cdh	cdh	cdh
ycgL	ycgL	ycgL
yjeH	yjeH	yjeH
yojI	yojI	yojI
fucPIKUR	fucP // fucI // fucK // fucU // fucR	fucP // fucI // fucK // fucU // fucR
yhiJ	yhiJ	yhiJ
tyrTV-tpr	tpr // tyrV // tyrT	tpr // tyrV // tyrT
gspCDEFGHIJKLMO	gspO // gspM // gspL // gspK // gspJ // gspI // gspH // gspG // gspF // gspE // gspD // gspC	gspO // gspM // gspL // gspK // gspJ // gspI // gspH // gspG // gspF // gspE // gspD // gspC
recF	recF	recF
ldcC	ldcC	ldcC
valS	valS	valS
pinE	pinE	pinE
yibT	yibT	yibT
nupX	nupX	nupX
asnA	asnA	asnA
asd	asd	asd
valUXY-lysV	valU // valX // valY // lysV	valU // valX // valY // lysV
rnd	rnd	rnd
amiA-hemF	hemF // amiA	hemF // amiA
astCADBE	astE // astB // astD // astA // astC	astE // astB // astD // astA // astC
cysG	cysG	cysG
ycfH // holB // tmk // mltG // pabC	ycfH // holB // tmk // mltG // pabC	ycfH // holB // tmk // mltG // pabC
yhbQ	yhbQ	yhbQ
yehS	yehS	yehS
aidB	aidB	aidB
kefG // kefB // yheV	kefG // kefB // yheV	kefG // kefB // yheV
ptsHI-crr	ptsH // ptsI // crr	ptsH // ptsI // crr
C0664	C0664	C0664
topA	topA	topA
plsB	plsB	plsB
yicR-rpmBG	rpmG // rpmB // yicR	rpmG // rpmB // yicR
ghrA	ghrA	ghrA
ybdL	ybdL	ybdL
yegTUV	yegV // yegU // yegT	yegV // yegU // yegT
cysK	cysK	cysK
yhcO	yhcO	yhcO
ppiA	ppiA	ppiA
hsdRMS	hsdS // hsdM // hsdR	hsdS // hsdM // hsdR
mfd	mfd	mfd
dsbC-recJ-prfB	prfB // recJ // dsbC	prfB // recJ // dsbC
ydiQRST-fadK	fadK // ydiT // ydiS // ydiR // ydiQ	fadK // ydiT // ydiS // ydiR // ydiQ
rlmI	rlmI	rlmI
yafS	yafS	yafS
yeeY	yeeY	yeeY
rhaSR	rhaS // rhaR	rhaS // rhaR
yhbE // obgE	yhbE // obgE	yhbE // obgE
clpA	clpA	clpA
yadMLKC	yadC // yadK // yadL // yadM	yadC // yadK // yadL // yadM
pspF	pspF	pspF
yjaB	yjaB	yjaB
ycaL	ycaL	ycaL
tdk	tdk	tdk
yeeL	yeeL	yeeL
nrdAB-yfaE	yfaE // nrdA // nrdB	yfaE // nrdA // nrdB
yhaL // yhaK	yhaL // yhaK	yhaL // yhaK
lrhA	lrhA	lrhA
ygbK	ygbK	ygbK
yhjH	pdeH	pdeH
gapA	gapA	gapA
rybB	rybB	rybB
sieB	sieB	sieB
yedL	yedL	yedL
glpD	glpD	glpD
ygjI	ygjI	ygjI
fimB	fimB	fimB
lfhA	lfhA	lfhA
pgk-fbaA	fbaA // pgk	fbaA // pgk
idnDOTR	idnR // idnT // idnO // idnD	idnR // idnT // idnO // idnD
ybiI	ybiI	ybiI
