"tRNA ID"	"anticodon 5' to 3'"	"amino acid"
"RNA0-300[c]"	"UAC"	"VAL[c]"
"RNA0-301[c]"	"UUU"	"LYS[c]"
"RNA0-302[c]"	"UUU"	"LYS[c]"
"RNA0-303[c]"	"UUU"	"LYS[c]"
"RNA0-304[c]"	"GUU"	"ASN[c]"
"RNA0-305[c]"	"CAU"	"ILE[c]"
"RNA0-306[c]"	"CAU"	"MET[c]"
"alaT-tRNA[c]"	"UGC"	"L-ALPHA-ALANINE[c]"
"alaU-tRNA[c]"	"UGC"	"L-ALPHA-ALANINE[c]"
"alaV-tRNA[c]"	"UGC"	"L-ALPHA-ALANINE[c]"
"alaW-tRNA[c]"	"GGC"	"L-ALPHA-ALANINE[c]"
"alaX-tRNA[c]"	"GGC"	"L-ALPHA-ALANINE[c]"
"argQ-tRNA[c]"	"ACG"	"ARG[c]"
"argU-tRNA[c]"	"UCU"	"ARG[c]"
"argV-tRNA[c]"	"ACG"	"ARG[c]"
"argW-tRNA[c]"	"CCU"	"ARG[c]"
"argX-tRNA[c]"	"CCG"	"ARG[c]"
"argY-tRNA[c]"	"ACG"	"ARG[c]"
"argZ-tRNA[c]"	"ACG"	"ARG[c]"
"asnT-tRNA[c]"	"GUU"	"ASN[c]"
"asnU-tRNA[c]"	"GUU"	"ASN[c]"
"asnV-tRNA[c]"	"GUU"	"ASN[c]"
"aspT-tRNA[c]"	"GUC"	"L-ASPARTATE[c]"
"aspU-tRNA[c]"	"GUC"	"L-ASPARTATE[c]"
"aspV-tRNA[c]"	"GUC"	"L-ASPARTATE[c]"
"cysT-tRNA[c]"	"GCA"	"CYS[c]"
"glnU-tRNA[c]"	"UUG"	"GLN[c]"
"glnV-tRNA[c]"	"CUG"	"GLN[c]"
"glnW-tRNA[c]"	"UUG"	"GLN[c]"
"glnX-tRNA[c]"	"CUG"	"GLN[c]"
"gltT-tRNA[c]"	"UUC"	"GLT[c]"
"gltU-tRNA[c]"	"UUC"	"GLT[c]"
"gltV-tRNA[c]"	"UUC"	"GLT[c]"
"gltW-tRNA[c]"	"UUC"	"GLT[c]"
"glyT-tRNA[c]"	"UCC"	"GLY[c]"
"glyU-tRNA[c]"	"CCC"	"GLY[c]"
"glyV-tRNA[c]"	"GCC"	"GLY[c]"
"glyW-tRNA[c]"	"GCC"	"GLY[c]"
"glyX-tRNA[c]"	"GCC"	"GLY[c]"
"glyY-tRNA[c]"	"GCC"	"GLY[c]"
"hisR-tRNA[c]"	"GUG"	"HIS[c]"
"ileT-tRNA[c]"	"GAU"	"ILE[c]"
"ileU-tRNA[c]"	"GAU"	"ILE[c]"
"ileV-tRNA[c]"	"GAU"	"ILE[c]"
"ileX-tRNA[c]"	"CAU"	"ILE[c]"
"leuP-tRNA[c]"	"CAG"	"LEU[c]"
"leuQ-tRNA[c]"	"CAG"	"LEU[c]"
"leuT-tRNA[c]"	"CAG"	"LEU[c]"
"leuU-tRNA[c]"	"GAG"	"LEU[c]"
"leuV-tRNA[c]"	"CAG"	"LEU[c]"
"leuW-tRNA[c]"	"UAG"	"LEU[c]"
"leuX-tRNA[c]"	"CAA"	"LEU[c]"
"leuZ-tRNA[c]"	"UAA"	"LEU[c]"
"lysT-tRNA[c]"	"UUU"	"LYS[c]"
"lysV-tRNA[c]"	"UUU"	"LYS[c]"
"lysW-tRNA[c]"	"UUU"	"LYS[c]"
"metT-tRNA[c]"	"CAU"	"MET[c]"
"metU-tRNA[c]"	"CAU"	"MET[c]"
"metW-tRNA[c]"	"CAU"	"MET[c]"
"metY-tRNA[c]"	"CAU"	"MET[c]"
"metZ-tRNA[c]"	"CAU"	"MET[c]"
"pheU-tRNA[c]"	"GAA"	"PHE[c]"
"pheV-tRNA[c]"	"GAA"	"PHE[c]"
"proK-tRNA[c]"	"CGG"	"PRO[c]"
"proL-tRNA[c]"	"GGG"	"PRO[c]"
"proM-tRNA[c]"	"UGG"	"PRO[c]"
"selC-tRNA[c]"	"UCA"	"L-SELENOCYSTEINE[c]"
"serT-tRNA[c]"	"UGA"	"SER[c]"
"serU-tRNA[c]"	"CGA"	"SER[c]"
"serV-tRNA[c]"	"GCU"	"SER[c]"
"serW-tRNA[c]"	"GGA"	"SER[c]"
"serX-tRNA[c]"	"GGA"	"SER[c]"
"thrT-tRNA[c]"	"GGU"	"THR[c]"
"thrU-tRNA[c]"	"UGU"	"THR[c]"
"thrV-tRNA[c]"	"GGU"	"THR[c]"
"thrW-tRNA[c]"	"CGU"	"THR[c]"
"trpT-tRNA[c]"	"CCA"	"TRP[c]"
"tyrT-tRNA[c]"	"GUA"	"TYR[c]"
"tyrU-tRNA[c]"	"GUA"	"TYR[c]"
"tyrV-tRNA[c]"	"GUA"	"TYR[c]"
"valT-tRNA[c]"	"UAC"	"VAL[c]"
"valU-tRNA[c]"	"UAC"	"VAL[c]"
"valV-tRNA[c]"	"GAC"	"VAL[c]"
"valW-tRNA[c]"	"GAC"	"VAL[c]"
"valX-tRNA[c]"	"UAC"	"VAL[c]"
"valY-tRNA[c]"	"UAC"	"VAL[c]"
